Details,Posting Date,Description,Amount,Type,Balance,Check or Slip #
CREDIT,7/15/19,ATM DEPOSIT,54,MISC_CREDIT, ,
DEBIT,7/15/19,MACYS  ,-53.49,MISC_DEBIT, ,
DEBIT,7/15/19,Tithes,-21.4,MISC_DEBIT, ,
DEBIT,7/15/19,Tithes,-21.4,MISC_DEBIT, ,
DEBIT,7/15/19,Groceries Brooklyn,-14.5,MISC_DEBIT, ,
DEBIT,7/15/19,Pizza,-7.08,MISC_DEBIT, ,
DEBIT,7/15/19,MTA Metro NY,-3,MISC_DEBIT, ,
DEBIT,7/15/19,MTA Metro NY,-12,MISC_DEBIT, ,
DEBIT,7/12/19,Acorns Investment,-5,ACH_DEBIT,201.96,
DEBIT,7/12/19,Acorns Investment,-10,ACH_DEBIT,206.96,
DEBIT,7/12/19,Groceries Brooklyn,-12.62,DEBIT_CARD,216.96,
DEBIT,7/12/19,Groceries Brooklyn,-2.98,DEBIT_CARD,229.58,
DEBIT,7/11/19,Books,-32.55,DEBIT_CARD,232.56,
DEBIT,7/10/19,Walgreens Groceries,-7.61,DEBIT_CARD,265.11,
DEBIT,7/9/19,Acorns Investment,-5.45,ACH_DEBIT,272.72,
DEBIT,7/8/19,CAPITAL ONE      ,-211.75,ACH_DEBIT,278.17,
DEBIT,7/8/19,CVS/PHARMACY,-11.42,DEBIT_CARD,489.92,
DEBIT,7/8/19,Walgreens Groceries,-7.48,DEBIT_CARD,501.34,
DEBIT,7/8/19,Walgreens Groceries,-3.69,DEBIT_CARD,508.82,
DEBIT,7/8/19,Fast Food MCF33302 MERRILLVILLE IN            07/06,-7.9,DEBIT_CARD,512.51,
DEBIT,7/8/19,SHOE CARNIVAL #0 2340 MERRILLVILLE IN739426  07/06,-80.24,DEBIT_CARD,520.41,
DEBIT,7/8/19,DSW CROSSINGS AT 2114 MERRILVILLE IN 914374  07/06,-21.39,DEBIT_CARD,600.65,
DEBIT,7/8/19,VILLAGE CLEANERS GARY IN     07/05,-25.8,DEBIT_CARD,622.04,
DEBIT,7/8/19,AMZN Mktp US*MH9KU5J Amzn.com/bill WA        07/06,-28.88,DEBIT_CARD,647.84,
CREDIT,7/8/19,QuickPay with Zelle payment from Amber Toussaint VSATAH60YQFR,15,PARTNERFI_TO_CHASE,676.72,
CREDIT,7/8/19,QuickPay with Zelle payment from KAREN L TYSON 8406749500,100,QUICKPAY_CREDIT,661.72,
DEBIT,7/5/19,NON-CHASE ATM FEE-WITH,-2.5,FEE_TRANSACTION,561.72,
DEBIT,7/5/19,Acorns Later     Transfer   NCCPHB          WEB ID: 9000142693,-5,ACH_DEBIT,564.22,
DEBIT,7/5/19,Acorns Investing Transfer   0D8KHB          WEB ID: 9000142693,-10,ACH_DEBIT,569.22,
DEBIT,7/5/19,GAS,-15,DEBIT_CARD,579.22,
DEBIT,7/5/19,Money Withdraw            365556  07/054605 BROA,-22.5,ATM,594.22,
DEBIT,7/5/19,VILLAGE CLEANERS GARY IN     07/03,-37.25,DEBIT_CARD,616.72,
CREDIT,7/5/19,GREENWOOD PROJEC PAYROLL    PPD ID: 1462800242,214.5,ACH_CREDIT,653.97,
DEBIT,7/3/19,CHIPOTLE 0240 CHICAGO IL     07/02,-9.87,DEBIT_CARD,439.47,
DEBIT,7/3/19,LITO`S EMPANADA CHICAGO IL   07/02,-8.57,DEBIT_CARD,449.34,
DEBIT,7/1/19,Subscription     Acorns     5VZWCB          WEB ID: 9000142693,-2,ACH_DEBIT,457.91,
DEBIT,7/1/19,Amazon Prime Amzn.com/bill WA06/30,-6.49,DEBIT_CARD,459.91,
DEBIT,7/1/19,CAPITAL ONE      MOBILE PMT 917939800511027 WEB ID: 9279744980,-25.7,ACH_DEBIT,466.4,
DEBIT,7/1/19,SQ *BARBERKINGS BARBE Merrillville IN        06/28,-20,DEBIT_CARD,492.1,
CREDIT,7/1/19,GREENWOOD PROJEC PAYROLL    PPD ID: 1462800242,225.5,ACH_CREDIT,512.1,
DEBIT,6/28/19,Acorns Later     Transfer   JN5JBB          WEB ID: 9000142693,-5,ACH_DEBIT,286.6,
DEBIT,6/28/19,Acorns Investing Transfer   STQHBB          WEB ID: 9000142693,-10,ACH_DEBIT,291.6,
CREDIT,6/28/19,Square Inc       * Cash App T200130993351   CCD ID: 8800429876,30,ACH_CREDIT,301.6,
CREDIT,6/27/19,Acorns Investing Transfer   PPD ID: 9000142693,9.96,ACH_CREDIT,271.6,
DEBIT,6/26/19,TARGET T-0870 2661 E MERRILLVILLE IN 526730  06/26,-11.27,DEBIT_CARD,261.64,
DEBIT,6/26/19,WALGREENS STORE 200 W CHICAGO IL     703942  06/26,-2.15,DEBIT_CARD,272.91,
DEBIT,6/26/19, LITO S EMPANADAS Fast Food ,-8.36,DEBIT_CARD,275.06,
DEBIT,6/26/19,SUBWAY        00003996 CHICAGO IL            06/25,-10.59,DEBIT_CARD,283.42,
CREDIT,6/26/19,Acorns Later     Transfer   PPD ID: 9000142693,15.33,ACH_CREDIT,294.01,
CREDIT,6/26/19,Acorns Investing Transfer   PPD ID: 9000142693,43.87,ACH_CREDIT,278.68,
DEBIT,6/24/19,Acorns Investing Transfer   6RSB8B          WEB ID: 9000142693,-10.3,ACH_DEBIT,234.81,
DEBIT,6/24/19,MEIJER 165 MERRILLVILLE IN           882006  06/24,-43.62,DEBIT_CARD,245.11,
DEBIT,6/24/19,Fiverr 855-5859699 NY        06/23,-12,DEBIT_CARD,288.73,
DEBIT,6/24/19,AMZN Mktp US*M60WP6U Amzn.com/bill WA        06/23,-19.99,DEBIT_CARD,300.73,
DEBIT,6/21/19,Acorns Later     Transfer   B4LN7B          WEB ID: 9000142693,-5,ACH_DEBIT,320.72,
DEBIT,6/21/19,Acorns Investing Transfer   555N7B          WEB ID: 9000142693,-10,ACH_DEBIT,325.72,
DEBIT,6/21/19,ALBANESE CONFECTIONER MERRILLVILLE IN        06/20,-8.53,DEBIT_CARD,335.72,
DEBIT,6/21/19,PARCHMENT - UNIV DOCS 480-719-1646 AZ        06/21,-10,DEBIT_CARD,344.25,
DEBIT,6/21/19,SUBWAY        03445418 CHICAGO IL            06/20,-9.13,DEBIT_CARD,354.25,
DEBIT,6/21/19,LONGHORN STEAK 012526 MERRILLVILLE IN        06/20,-32.08,DEBIT_CARD,363.38,
CREDIT,6/21/19,GREENWOOD PROJEC PAYROLL    PPD ID: 1462800242,312,ACH_CREDIT,395.46,
DEBIT,6/20/19,PARCHMENT - UNIV DOCS 480-719-1646 AZ        06/20,-10,DEBIT_CARD,83.46,
DEBIT,6/18/19,CAPITAL ONE      MOBILE PMT 916839800170721 WEB ID: 9279744980,-240.12,ACH_DEBIT,93.46,
DEBIT,6/18/19,PNW ADMISSIONS 219-989-3122 IN               06/18,-55,DEBIT_CARD,333.58,
DEBIT,6/18/19,CINNABON #28 MERRILLVILLE IN 06/17,-5.87,DEBIT_CARD,388.58,
DEBIT,6/17/19,EIG*Hostgator.com 713-5745287 MA             06/16,-10.95,DEBIT_CARD,394.45,
DEBIT,6/17/19,SPRINT *WIRELESS 800-639-6111 KS             06/15,-35.18,DEBIT_CARD,405.4,
DEBIT,6/17/19,Tithes,-28.45,DEBIT_CARD,440.58,
CREDIT,6/17/19,ATM CHECK DEPOSIT 06/17 1837 E 80TH AVE MERRILLVILLE IN,129.25,ATM_DEPOSIT,469.03,
DEBIT,6/14/19,Acorns Later     Transfer   DL3X4B          WEB ID: 9000142693,-5,ACH_DEBIT,339.78,
DEBIT,6/14/19,Acorns Investing Transfer   V7T25B          WEB ID: 9000142693,-10,ACH_DEBIT,344.78,
CREDIT,6/14/19,GREENWOOD PROJEC PAYROLL    PPD ID: 1462800242,284.5,ACH_CREDIT,354.78,
DEBIT,6/13/19,STRACK & VAN TIL #8797 CROWN POINT IN        06/12,-82.44,DEBIT_CARD,70.28,
DEBIT,6/12/19,Acorns Investing Transfer   H1T24B          WEB ID: 9000142693,-7.39,ACH_DEBIT,152.72,
DEBIT,6/12/19,ALDI 62025 CROWN POINT IN            917393  06/12,-14.56,DEBIT_CARD,160.11,
DEBIT,6/12/19,SOUTH SHORE RR 219-874-4221 IN               06/12,-129.25,DEBIT_CARD,174.67,
DEBIT,6/11/19,PANDA EXPRESS #1472 MERRILLVILLE IN          06/10,-6.48,DEBIT_CARD,303.92,
DEBIT,6/10/19,Walgreens Groceries IN608606  06/10,-3.99,DEBIT_CARD,310.4,
DEBIT,6/10/19,SOUTH SHORE RR 219-874-4221 IN               06/08,-7.5,DEBIT_CARD,314.39,
DEBIT,6/10/19,CHIPOTLE 0088 CHICAGO IL     06/07,-8.36,DEBIT_CARD,321.89,
DEBIT,6/10/19,DUSABLE MUSEUM CHICAGO IL    06/07,-7,DEBIT_CARD,330.25,
DEBIT,6/10/19,SOUTH SHORE RR 219-874-4221 IN               06/08,-6.75,DEBIT_CARD,337.25,
CREDIT,6/10/19,GREENWOOD PROJEC PAYROLL    PPD ID: 1462800242,301,ACH_CREDIT,344,
DEBIT,6/7/19,Acorns Later     Transfer   FBK72B          WEB ID: 9000142693,-5,ACH_DEBIT,43,
DEBIT,6/7/19,Acorns Investing Transfer   XRX62B          WEB ID: 9000142693,-10,ACH_DEBIT,48,
DEBIT,6/7/19,QuickPay with Zelle payment to Sydney Taylor ,-4.25,QUICKPAY_DEBIT,58,
DEBIT,6/7/19,AMZN Mktp US*M69062L Amzn.com/bill WA        06/07,-24.42,DEBIT_CARD,62.25,
DEBIT,6/7/19,SOUTH SHORE RR 219-874-4221 IN               06/07,-7,DEBIT_CARD,86.67,
DEBIT,6/7/19,GARRETT POPCORN SHOPS CHICAGO IL             06/06,-5.4,DEBIT_CARD,93.67,
DEBIT,6/7/19,LASALLE CAFE  11308764 CHICAGO IL            06/06,-6.78,DEBIT_CARD,99.07,
DEBIT,6/7/19,SOUTH SHORE RR 219-874-4221 IN               06/07,-7.5,DEBIT_CARD,105.85,
DEBIT,6/6/19,Acorns Investing Transfer   JNHS1B          WEB ID: 9000142693,-5.33,ACH_DEBIT,113.35,
DEBIT,6/6/19,TARGET T-2799 1 S Stat CHICAGO IL    563736  06/06,-3.41,DEBIT_CARD,118.68,
DEBIT,6/5/19,SOUTH SHORE RR 219-874-4221 IN               06/05,-7.5,DEBIT_CARD,122.09,
DEBIT,6/5/19,SUBWAY        03267713 CHICAGO IL            06/04,-4,DEBIT_CARD,129.59,
DEBIT,6/5/19,SOUTH SHORE RR 219-874-4221 IN               06/05,-7.5,DEBIT_CARD,133.59,
DEBIT,6/4/19,SOUTH SHORE RR 219-874-4221 IN               06/04,-7.5,DEBIT_CARD,141.09,
DEBIT,6/4/19,SOUTH SHORE RR 219-874-4221 IN               06/04,-7,DEBIT_CARD,148.59,
DEBIT,6/3/19,QuickPay with Zelle payment to Sarita Stevens 8292053900,-40,QUICKPAY_DEBIT,155.59,
DEBIT,6/3/19,Online Transfer to CHK ...4842 transaction#: 8292045182 06/03,-12,ACCT_XFER,195.59,
DEBIT,6/3/19,SOUTH SHORE RR 219-874-4221 IN               06/01,-7,DEBIT_CARD,207.59,
DEBIT,5/31/19,Acorns Later     Transfer   SS9QX9          WEB ID: 9000142693,-5,ACH_DEBIT,214.59,
DEBIT,5/31/19,Amazon Prime Amzn.com/bill WA05/31,-6.49,DEBIT_CARD,219.59,
DEBIT,5/31/19,Acorns Investing Transfer   GF2PX9          WEB ID: 9000142693,-10,ACH_DEBIT,226.08,
DEBIT,5/31/19,QuickPay with Zelle payment to Skip 8286616124,-20,QUICKPAY_DEBIT,236.08,
DEBIT,5/31/19,SOUTH SHORE RR 219-874-4221 IN               05/31,-7,DEBIT_CARD,256.08,
DEBIT,5/31/19,SOUTH SHORE RR 219-874-4221 IN               05/31,-7,DEBIT_CARD,263.08,
DEBIT,5/30/19,CAPITAL ONE      MOBILE PMT 914939800041194 WEB ID: 9279744980,-43.19,ACH_DEBIT,270.08,
DEBIT,5/30/19,Walgreens Groceries IN562915  05/30,-3.68,DEBIT_CARD,313.27,
DEBIT,5/30/19,SOUTH SHORE RR 219-874-4221 IN               05/30,-7,DEBIT_CARD,316.95,
DEBIT,5/30/19,SOUTH SHORE RR 219-874-4221 IN               05/30,-7,DEBIT_CARD,323.95,
CREDIT,5/30/19,"QuickPay with Zelle payment from MILLERCASTRO, ANITA BAC9f460330a",60,PARTNERFI_TO_CHASE,330.95,
DEBIT,5/30/19,PAYPAL *TECHREDO 402-935-7733 CA             05/29,47.1,DEBIT_CARD,270.95,
DEBIT,5/29/19,QuickPay with Zelle payment to Skip 8276913084,-20,QUICKPAY_DEBIT,223.85,
DEBIT,5/29/19,PANDA EXPRESS #1472 MERRILLVILLE IN          05/28,-8.24,DEBIT_CARD,243.85,
DEBIT,5/29/19,SOUTH SHORE RR 219-874-4221 IN               05/29,-7,DEBIT_CARD,252.09,
DEBIT,5/29/19,POTBELLY #245 CHICAGO IL     05/28,-4.46,DEBIT_CARD,259.09,
DEBIT,5/29/19,SOUTH SHORE RR 219-874-4221 IN               05/29,-7,DEBIT_CARD,263.55,
DEBIT,5/28/19,ATM WITHDRAWAL       005170  05/276790 BROA,-20,ATM,270.55,
DEBIT,5/28/19,WENDY S #331 MERRILLVILLE IN 05/24,-4.68,DEBIT_CARD,290.55,
DEBIT,5/28/19,AMZN Mktp US*MN74I2K Amzn.com/bill WA        05/24,-12.96,DEBIT_CARD,295.23,
CREDIT,5/28/19,Online Transfer from CHK ...4842 transaction#: 8273897488,1.27,ACCT_XFER,308.19,
CREDIT,5/28/19,Online Transfer from CHK ...4842 transaction#: 8273896486,40,ACCT_XFER,306.92,
DEBIT,5/28/19,AMZN Mktp US Amzn.com/bill WA05/25,7.43,DEBIT_CARD,266.92,
DEBIT,5/28/19,AMZN Mktp US Amzn.com/bill WA05/26,38.06,DEBIT_CARD,259.49,
DEBIT,5/24/19,ALDI 62074 MERRILLVILLE IN           057594  05/24,-10.23,DEBIT_CARD,221.43,
DEBIT,5/24/19,ATM WITHDRAWAL       003508  05/246790 BROA,-40,ATM,231.66,
DEBIT,5/24/19,PAYPAL *TithesHOLDFA 402-935-7733 CA          05/23,-13,DEBIT_CARD,271.66,
CREDIT,5/24/19,Online Transfer from CHK ...4842 transaction#: 8264332624,8,ACCT_XFER,284.66,
CREDIT,5/24/19,Online Transfer from CHK ...4842 transaction#: 8264306864,10,ACCT_XFER,276.66,
CREDIT,5/24/19,Online Transfer from CHK ...4842 transaction#: 8260713937,12,ACCT_XFER,266.66,
CREDIT,5/24/19,Online Transfer from CHK ...4842 transaction#: 8264013162,40,ACCT_XFER,254.66,
CREDIT,5/24/19,QuickPay with Zelle payment from CHRISTOPHER D BURNETT 8264613400,100,QUICKPAY_CREDIT,214.66,
DEBIT,5/24/19,AMZN Mktp US Amzn.com/bill WA05/24,8.99,DEBIT_CARD,114.66,
DEBIT,5/24/19,AMZN Mktp US Amzn.com/bill WA05/23,37.44,DEBIT_CARD,105.67,
DEBIT,5/24/19,AMZN Mktp US Amzn.com/bill WA05/23,53.49,DEBIT_CARD,68.23,
CREDIT,5/23/19,Online Transfer from CHK ...4842 transaction#: 8258919242,14,ACCT_XFER,14.74,
DEBIT,5/22/19,CAPITAL ONE      MOBILE PMT 914139800427222 WEB ID: 9279744980,-39,ACH_DEBIT,0.74,
DEBIT,5/22/19,QuickPay with Zelle payment to RJ 8256295248,-125,QUICKPAY_DEBIT,39.74,
DEBIT,5/22/19,PAYPAL *JMPJ 402-935-7733 CA 05/22,-2.99,DEBIT_CARD,164.74,
DEBIT,5/22/19,Walgreens Groceries IN546275  05/21,-21.39,DEBIT_CARD,167.73,
DEBIT,5/22/19,UBER   *TRIP 800-592-8996 CA 05/21,-7.62,DEBIT_CARD,189.12,
DEBIT,5/22/19,Podiatric Medical Ass MERRILLVILLE IN        05/21,-30,DEBIT_CARD,196.74,
DEBIT,5/22/19,UBER   *TRIP 800-592-8996 CA 05/21,-7.53,DEBIT_CARD,226.74,
DEBIT,5/22/19,AMZN Mktp US*MN8ZR9H Amzn.com/bill WA        05/22,-14.86,DEBIT_CARD,234.27,
CREDIT,5/22/19,Online Transfer from CHK ...4842 transaction#: 8256291870,125,ACCT_XFER,249.13,
DEBIT,5/21/19,AMZN Mktp US*MN1B85M Amzn.com/bill WA        05/20,-6.5,DEBIT_CARD,124.13,
CREDIT,5/21/19,Online Transfer from CHK ...4842 transaction#: 8252805609,10,ACCT_XFER,130.63,
CREDIT,5/21/19,Online Transfer from CHK ...4842 transaction#: 8252960327,18,ACCT_XFER,120.63,
CREDIT,5/21/19,Online Transfer from CHK ...4842 transaction#: 8252687796,30,ACCT_XFER,102.63,
CREDIT,5/21/19,Online Transfer from CHK ...4842 transaction#: 8253299214,50,ACCT_XFER,72.63,
DEBIT,5/20/19,AMZN Mktp US*MN64J1X Amzn.com/bill WA        05/20,-137.98,DEBIT_CARD,22.63,
DEBIT,5/20/19,Online Transfer to CHK ...4842 transaction#: 8246703435 05/20,-30,ACCT_XFER,160.61,
DEBIT,5/20/19,AMK DELOITTE BISTRO CHICAGO IL               05/17,-3.9,DEBIT_CARD,190.61,
DEBIT,5/20/19,SOUTH SHORE RR 219-874-4221 IN               05/18,-7.5,DEBIT_CARD,194.51,
CREDIT,5/20/19,Online Transfer from CHK ...4842 transaction#: 8246704198,60,ACCT_XFER,202.01,
DEBIT,5/17/19,Microsoft*EA Access 1 M Redmond WA           05/17,-4.99,DEBIT_CARD,142.01,
DEBIT,5/17/19,EIG*Hostgator.com 713-5745287 MA             05/16,-10.95,DEBIT_CARD,147,
CREDIT,5/17/19,Acco PAYROLL    PPD ID: 1356001670,128.15,ACH_CREDIT,157.95,
DEBIT,5/16/19,SPRINT *WIRELESS 800-639-6111 KS             05/16,-29.83,DEBIT_CARD,29.8,
DEBIT,5/16/19,MEIJER # 165 611 W LI MERRILLVILLE IN        05/16 Purchase $36.23 Cash Back $10.00,-46.23,DEBIT_CARD,59.63,
DEBIT,5/16/19,MEIJER # 165 611 W LI MERRILLVILLE IN626727  05/16,-4.91,DEBIT_CARD,105.86,
DEBIT,5/16/19,PAYPAL *TECHREDO 402-935-7733 CA             05/16,-47.1,DEBIT_CARD,110.77,
DEBIT,5/15/19,Walgreens Groceries IN504925  05/14,-2.13,DEBIT_CARD,157.87,
DEBIT,5/14/19,UDEMY ONLINE COURSES HTTPSWWW.UDEM CA        05/13,-14.99,DEBIT_CARD,160,
DEBIT,5/14/19,PAYPAL *MORGANCASTR 402-935-7733 CA          05/13,-10.59,DEBIT_CARD,174.99,
DEBIT,5/14/19,PAYPAL *MORGANCASTR 402-935-7733 CA          05/14,10.59,DEBIT_CARD,185.58,
DEBIT,5/13/19,MEIJER # 165 611 W LI MERRILLVILLE IN946218  05/12,-27.33,DEBIT_CARD,174.99,
DEBIT,5/10/19,SHELL Service Station TERRE HAUTE IN 939930  05/10,-2.49,DEBIT_CARD,202.32,
DEBIT,5/10/19,IMPERIAL LANES TERRE HAUTE IN05/08,-12,DEBIT_CARD,204.81,
CREDIT,5/9/19,QuickPay with Zelle payment from RAMON JOSEPH HARRIS JR 8213096853,20,QUICKPAY_CREDIT,216.81,
CREDIT,5/8/19,INDIANA STATE UN INVOICE    PPD ID: 1356001670,29.57,ACH_CREDIT,196.81,
DEBIT,5/7/19,SQC*CASH APP CEECEE 8774174551 CA            05/06,-4,DEBIT_CARD,167.24,
DEBIT,5/7/19,ISU ADMIN WEB 812-2373511 IN 05/06,-35,DEBIT_CARD,171.24,
DEBIT,5/6/19,WAL Wal-Mart Super 110 TERRE HAUTE IN381557  05/06,-8.88,DEBIT_CARD,206.24,
DEBIT,5/6/19,ALDI 44065 TERRE HAUTE IN            080621  05/06,-36.13,DEBIT_CARD,215.12,
CREDIT,5/6/19,Square Inc       Austi      T200116686630   CCD ID: 8800429876,53,ACH_CREDIT,251.25,
CREDIT,5/3/19,ISU PAYROLL,169.89,ACH_CREDIT,198.25,
DEBIT,5/3/19,AMZN Mktp US Amzn.com/bill WA05/02,24.99,DEBIT_CARD,28.36,
DEBIT,5/1/19,AMZN Mktp US*MZ5BX7U Amzn.com/bill WA        04/30,-16.99,DEBIT_CARD,3.37,
DEBIT,4/30/19,Amazon Prime Amzn.com/bill WA04/30,-6.49,DEBIT_CARD,20.36,
DEBIT,4/30/19,AMZN Mktp US*MZ01D4S Amzn.com/bill WA        04/29,-52.98,DEBIT_CARD,26.85,
DEBIT,4/30/19,GREYHOUND LINES CNP 214-849-8966 TX          04/29,-57.5,DEBIT_CARD,79.83,
CREDIT,4/30/19,Online Transfer from CHK ...4842 transaction#: 8181635534,4,ACCT_XFER,137.33,
CREDIT,4/30/19,Online Transfer from CHK ...4842 transaction#: 8181321852,20,ACCT_XFER,133.33,
DEBIT,4/29/19,ADOBE *CREATIVE CLOUD 800-833-6687 CA        04/27,-21.39,DEBIT_CARD,113.33,
DEBIT,4/29/19,MEIJER # 165 611 W LI MERRILLVILLE IN556162  04/28,-9.46,DEBIT_CARD,134.72,
DEBIT,4/29/19,TARGET T-0870 2661 E MERRILLVILLE IN 404352  04/28,-8.26,DEBIT_CARD,144.18,
DEBIT,4/29/19,TAL INDIANAPOLIS MERRIAM KS  04/25,-1.35,DEBIT_CARD,152.44,
DEBIT,4/29/19,TAL INDIANAPOLIS MERRIAM KS  04/25,-1.35,DEBIT_CARD,153.79,
CREDIT,4/29/19,Online Transfer from CHK ...4842 transaction#: 8177180656,3,ACCT_XFER,155.14,
CREDIT,4/29/19,Online Transfer from CHK ...4842 transaction#: 8175650498,5,ACCT_XFER,152.14,
CREDIT,4/29/19,Online Transfer from CHK ...4842 transaction#: 8177068866,7,ACCT_XFER,147.14,
CREDIT,4/29/19,Online Transfer from CHK ...4842 transaction#: 8175705576,7,ACCT_XFER,140.14,
CREDIT,4/29/19,Online Transfer from CHK ...4842 transaction#: 8175500887,20,ACCT_XFER,133.14,
CREDIT,4/29/19,Online Transfer from CHK ...4842 transaction#: 8174482812,25,ACCT_XFER,113.14,
CREDIT,4/29/19,Online Transfer from CHK ...4842 transaction#: 8175704829,40,ACCT_XFER,88.14,
CREDIT,4/29/19,Online Transfer from CHK ...4842 transaction#: 8177061025,45,ACCT_XFER,48.14,
DEBIT,4/26/19,QuickPay with Zelle payment to Kevonte 8166959278,-10,QUICKPAY_DEBIT,3.14,
CREDIT,4/26/19,Online Transfer from CHK ...4842 transaction#: 8166958310,3,ACCT_XFER,13.14,
DEBIT,4/25/19,Online Transfer to CHK ...4842 transaction#: 8166957405 04/25,-2,ACCT_XFER,10.14,
DEBIT,4/25/19,AMZN Mktp US*MZ8X06Q Amzn.com/bill WA        04/24,-8.99,DEBIT_CARD,12.14,
DEBIT,4/24/19,SPRINT RETAIL #236018 TERRE HAUTE IN         04/23,-35.09,DEBIT_CARD,21.13,
DEBIT,4/24/19,TAL INDIANAPOLIS MERRIAM KS  04/23,-1.35,DEBIT_CARD,56.22,
DEBIT,4/24/19,Amazon.com*MZ0Q92M60 Amzn.com/bill WA        04/23,-14.98,DEBIT_CARD,57.57,
DEBIT,4/23/19,ISU LIB COFF  23058878 TERRE HAUTE IN        04/22,-1.49,DEBIT_CARD,72.55,
CREDIT,4/23/19,Online Transfer from CHK ...4842 transaction#: 8160072681,30,ACCT_XFER,74.04,
DEBIT,4/22/19,KROGER 987 TERRE HAUTE IN            734545  04/22,-9.5,DEBIT_CARD,44.04,
DEBIT,4/22/19,QuickPay with Zelle payment to Kevonte 8156756240,-10,QUICKPAY_DEBIT,53.54,
DEBIT,4/22/19,PAYPAL *TithesHOLDFA 402-935-7733 CA          04/20,-30.53,DEBIT_CARD,63.54,
CREDIT,4/22/19,Online Transfer from CHK ...4842 transaction#: 8156754845,10,ACCT_XFER,94.07,
CREDIT,4/22/19,Online Transfer from CHK ...4842 transaction#: 8156988878,50,ACCT_XFER,84.07,
DEBIT,4/19/19,Online Transfer to CHK ...4842 transaction#: 8147936593 04/19,-200,ACCT_XFER,34.07,
DEBIT,4/19/19,SQ *OY VEY BAKERY AND terre haute IN         04/18,-15.12,DEBIT_CARD,234.07,
DEBIT,4/19/19,AMZN Mktp US*MZ3H320 Amzn.com/bill WA        04/19,-9,DEBIT_CARD,249.19,
CREDIT,4/19/19,ISU PAYROLL,225.27,ACH_CREDIT,258.19,
DEBIT,4/18/19,Steamgames.com42595229 425-9522985 WA        04/17,-5,DEBIT_CARD,32.92,
CREDIT,4/18/19,Online Transfer from CHK ...4842 transaction#: 8143179114,20,ACCT_XFER,37.92,
DEBIT,4/18/19,STEAMGAMES.COM 425-889-9642 WA               04/17,5.69,DEBIT_CARD,17.92,
DEBIT,4/17/19,STEAMGAMES.COM 425-889-9642 WA               04/15,-5.69,DEBIT_CARD,12.23,
DEBIT,4/17/19,EIG*Hostgator.com 713-5745287 MA             04/16,-10.95,DEBIT_CARD,17.92,
DEBIT,4/17/19,WM SUPERCENTER # TERRE HAUTE IN      031241  04/16,-2.68,DEBIT_CARD,28.87,
DEBIT,4/17/19,AMZN Mktp US*MZ0UJ3Z Amzn.com/bill WA        04/17,-24.99,DEBIT_CARD,31.55,
DEBIT,4/17/19,ISU LIB COFF  23058878 TERRE HAUTE IN        04/16,-3.69,DEBIT_CARD,56.54,
DEBIT,4/16/19,KROGER 987 TERRE HAUTE IN            723568  04/16,-43.15,DEBIT_CARD,60.23,
DEBIT,4/16/19,TERRE HAUTE RURAL KING TERRE HAUTE IN        04/15,-3.49,DEBIT_CARD,103.38,
DEBIT,4/16/19,ISU LIB COFF  23058878 TERRE HAUTE IN        04/15,-4.99,DEBIT_CARD,106.87,
CREDIT,4/16/19,Online Transfer from CHK ...4842 transaction#: 8139959302,50,ACCT_XFER,111.86,
DEBIT,4/15/19,QuickPay with Zelle payment to Kevonte 8130843836,-5,QUICKPAY_DEBIT,61.86,
DEBIT,4/15/19,SQ *AMERICAN LEGENDS BRAZIL IN               04/12,-15,DEBIT_CARD,66.86,
DEBIT,4/12/19,Online Transfer to CHK ...4842 transaction#: 8126895071 04/12,-180,ACCT_XFER,81.86,
DEBIT,4/12/19,PAYPAL *SIMUNLOCKLI 4029357733               04/11,-0.99,DEBIT_CARD,261.86,
CREDIT,4/12/19,Square Inc       Austi      T200110970036   CCD ID: 8800429876,80,ACH_CREDIT,262.85,
DEBIT,4/12/19,AMZN Mktp US Amzn.com/bill WA04/11,27.99,DEBIT_CARD,182.85,
DEBIT,4/12/19,AMZN Mktp US Amzn.com/bill WA04/11,32.99,DEBIT_CARD,154.86,
DEBIT,4/11/19,PAYPAL *ZEERAAN321 402-935-7733 CA           04/11,-10,DEBIT_CARD,121.87,
DEBIT,4/10/19,PAYPAL *TithesHOLDFA 402-935-7733 CA          04/10,-10.3,DEBIT_CARD,131.87,
DEBIT,4/10/19,Isu Cupboard      04/09,-2.91,DEBIT_CARD,142.17,
DEBIT,4/10/19,ISU LIB COFF  23058878 TERRE HAUTE IN        04/09,-3.99,DEBIT_CARD,145.08,
DEBIT,4/10/19,AMZN Mktp US*MW5S81U Amzn.com/bill WA        04/09,-30.99,DEBIT_CARD,149.07,
CREDIT,4/10/19,Square Inc       Austi      T200110568147   CCD ID: 8800429876,50,ACH_CREDIT,180.06,
DEBIT,4/9/19,ISU LIB COFF  23058878 TERRE HAUTE IN        04/08,-3.69,DEBIT_CARD,130.06,
DEBIT,4/8/19,QuickPay with Zelle payment to RJ 8110981886,-4,QUICKPAY_DEBIT,133.75,
DEBIT,4/8/19,XTREME LAZER TAG - TER TERRE HAUTE IN        04/07,-15,DEBIT_CARD,137.75,
DEBIT,4/8/19,Prime Video*MW3CO2WO1 888-802-3080 WA        04/07,-4.99,DEBIT_CARD,152.75,
DEBIT,4/8/19,Isu Cupboard      04/06,-2.91,DEBIT_CARD,157.74,
DEBIT,4/8/19,AMZN Mktp US*MW6GJ6Y Amzn.com/bill WA        04/07,-6.25,DEBIT_CARD,160.65,
CREDIT,4/8/19,Square Inc       Austi      T200109486894   CCD ID: 8800429876,50,ACH_CREDIT,166.9,
CREDIT,4/5/19,ISU PAYROLL,103.74,ACH_CREDIT,116.9,
DEBIT,4/4/19,AMZN Mktp US*MW5VP9Q Amzn.com/bill WA        04/03,-60.98,DEBIT_CARD,13.16,
DEBIT,4/4/19,BUFFALO WILD WINGS 032 TERRE HAUTE IN        04/02,-16.19,DEBIT_CARD,74.14,
CREDIT,4/4/19,Online Transfer from CHK ...4842 transaction#: 8101234503,10,ACCT_XFER,90.33,
DEBIT,4/3/19,Isu Cupboard      04/02,-2.91,DEBIT_CARD,80.33,
DEBIT,4/3/19,ISU LIB COFF  23058878 TERRE HAUTE IN        04/02,-4.19,DEBIT_CARD,83.24,
DEBIT,4/3/19,1059 Dominos Pizza SOUTHFIELD MI             03/29,-12.71,DEBIT_CARD,87.43,
CREDIT,4/3/19,Online Transfer from CHK ...4842 transaction#: 8095039939,60,ACCT_XFER,100.14,
DEBIT,4/2/19,Isu Cupboard      04/01,-2.91,DEBIT_CARD,40.14,
DEBIT,4/2/19,AMZN Mktp US*MW4K51Q Amzn.com/bill WA        04/02,-48.98,DEBIT_CARD,43.05,
DEBIT,4/2/19,AMZN Mktp US*MW8IZ9H Amzn.com/bill WA        04/01,-59.99,DEBIT_CARD,92.03,
CREDIT,4/2/19,Online Transfer from CHK ...4842 transaction#: 8094430469,10,ACCT_XFER,152.02,
DEBIT,4/1/19,Amazon Prime Amzn.com/bill WA03/31,-6.49,DEBIT_CARD,142.02,
DEBIT,4/1/19,SQC*TAKEIRA 8774174551 CA    03/31,-20,DEBIT_CARD,148.51,
DEBIT,4/1/19,SHELL Service Station JACKSON MI     829864  03/31,-0.99,DEBIT_CARD,168.51,
DEBIT,4/1/19,QDOBA 2722 JACKSON MI        03/31,-2.17,DEBIT_CARD,169.5,
DEBIT,4/1/19,QDOBA 2722 JACKSON MI        03/31,-8.43,DEBIT_CARD,171.67,
DEBIT,4/1/19,SHAKE SHACK 1182 DETROIT MI  03/28,-9.09,DEBIT_CARD,180.1,
DEBIT,3/29/19,DETROIT REGIONAL CONVE DETROIT MI    891712  03/29,-1.5,DEBIT_CARD,189.19,
DEBIT,3/29/19,AMERICAN CONEY ISLAND D DETROIT MI           03/28,-8.94,DEBIT_CARD,190.69,
DEBIT,3/28/19,SQC*JAWAUN T 8774174551 CA   03/27,-7.5,DEBIT_CARD,199.63,
DEBIT,3/28/19,SQC*CHARLES YOUNG 8774174551 CA              03/27,-20,DEBIT_CARD,207.13,
DEBIT,3/28/19,EXACT TIME MERRILLVILLE IN   03/26,171.2,DEBIT_CARD,227.13,
DEBIT,3/27/19,ADOBE *CREATIVE CLOUD 800-833-6687 CA        03/27,-21.39,DEBIT_CARD,55.93,
DEBIT,3/27/19,QuickPay with Zelle payment to SYMEON L COLQUITT 8071606802,-12.25,QUICKPAY_DEBIT,77.32,
DEBIT,3/27/19,DETROIT REGIONAL CONVE DETROIT MI    889812  03/27,-2,DEBIT_CARD,89.57,
DEBIT,3/27/19,SAVE-A-LOT #24091 DETROIT MI         844004  03/27,-5.97,DEBIT_CARD,91.57,
DEBIT,3/27/19,Online Transfer to CHK ...4842 transaction#: 8070148787 03/27,-120,ACCT_XFER,97.54,
DEBIT,3/27/19,CVS/PHARMACY #08 08267 Detroit MI    715846  03/27,-23.6,DEBIT_CARD,217.54,
DEBIT,3/27/19,SQC*TENYRAA TROTTER 8774174551 CA            03/26,-5,DEBIT_CARD,241.14,
DEBIT,3/27/19,SQC*JAWAUN T 8774174551 CA   03/26,-20,DEBIT_CARD,246.14,
DEBIT,3/27/19,EXACT TIME MERRILLVILLE IN   03/25,-171.2,DEBIT_CARD,266.14,
CREDIT,3/27/19,Online Transfer from CHK ...4842 transaction#: 8071289574,10,ACCT_XFER,437.34,
CREDIT,3/27/19,Online Transfer from CHK ...4842 transaction#: 8071424244,20,ACCT_XFER,427.34,
CREDIT,3/27/19,Online Transfer from CHK ...4842 transaction#: 8070295521,20,ACCT_XFER,407.34,
DEBIT,3/26/19,TARGET T-0870 2661 E MERRILLVILLE IN 839485  03/26,-31.01,DEBIT_CARD,387.34,
DEBIT,3/26/19,VALUE DRYCLEAN INC MERRILLVILLE IN           03/25,-41.75,DEBIT_CARD,418.35,
DEBIT,3/26/19,M&M BEAUTY SUPPLY & W MERRILLVILLE IN        03/25,-11.53,DEBIT_CARD,460.1,
CREDIT,3/26/19,Online Transfer from CHK ...4842 transaction#: 8067746178,200,ACCT_XFER,471.63,
DEBIT,3/25/19,EIG*Hostgator.com 713-5745287 MA             03/22,-38.85,DEBIT_CARD,271.63,
DEBIT,3/25/19,OFFICE DEPOT 00 2240 MERRILLVILLE IN 618962  03/25,-10.7,DEBIT_CARD,310.48,
DEBIT,3/25/19,TJ MAXX #812 SCHEREVILLE IN          028541  03/24,-24.59,DEBIT_CARD,321.18,
DEBIT,3/25/19,NORDSTROM RACK # 185 SCHERERVILLE IN 159349  03/24,-32.07,DEBIT_CARD,345.77,
DEBIT,3/25/19,STARDUST BOWL II MERRILLVILLE IN             03/23,-10.4,DEBIT_CARD,377.84,
DEBIT,3/25/19,PAYPAL *TithesHOLDFA 402-935-7733 CA          03/24,-30,DEBIT_CARD,388.24,
CREDIT,3/25/19,Online Transfer from CHK ...4842 transaction#: 8065943430,2,ACCT_XFER,418.24,
CREDIT,3/25/19,Online Transfer from CHK ...4842 transaction#: 8064704736,10,ACCT_XFER,416.24,
CREDIT,3/25/19,Online Transfer from CHK ...4842 transaction#: 8065180496,11,ACCT_XFER,406.24,
CREDIT,3/25/19,Online Transfer from CHK ...4842 transaction#: 8066179984,20,ACCT_XFER,395.24,
CREDIT,3/25/19,Online Transfer from CHK ...4842 transaction#: 8060768921,24,ACCT_XFER,375.24,
CREDIT,3/25/19,Online Transfer from CHK ...4842 transaction#: 8062147400,25,ACCT_XFER,351.24,
CREDIT,3/25/19,Online Transfer from CHK ...4842 transaction#: 8062060624,30,ACCT_XFER,326.24,
CREDIT,3/25/19,Online Transfer from CHK ...4842 transaction#: 8061002849,40,ACCT_XFER,296.24,
CREDIT,3/25/19,Online Transfer from CHK ...4842 transaction#: 8065942515,41,ACCT_XFER,256.24,
CREDIT,3/25/19,Online Transfer from CHK ...4842 transaction#: 8064989595,170,ACCT_XFER,215.24,
DEBIT,3/22/19,Online Transfer to CHK ...4842 transaction#: 8055030162 03/22,-300,ACCT_XFER,45.24,
DEBIT,3/22/19,ISU LIB COFF  23058878 TERRE HAUTE IN        03/21,-0.99,DEBIT_CARD,345.24,
DEBIT,3/22/19,Isu Cupboard      03/21,-0.42,DEBIT_CARD,346.23,
DEBIT,3/22/19,ISU SUBVERSION23024326 TERRE HAUTE IN        03/21,-2.79,DEBIT_CARD,346.65,
DEBIT,3/22/19,Isu Cupboard      03/21,-1.07,DEBIT_CARD,349.44,
DEBIT,3/22/19,UBER   *TRIP 800-592-8996 CA 03/21,-6.78,DEBIT_CARD,350.51,
CREDIT,3/22/19,Online Transfer from CHK ...4842 transaction#: 8054477605,38,ACCT_XFER,357.29,
CREDIT,3/22/19,ISU PAYROLL,306.42,ACH_CREDIT,319.29,
DEBIT,3/21/19,UBR* PENDING.UBER.COM 800-592-8996 CA        03/21,-3.26,DEBIT_CARD,12.87,
DEBIT,3/21/19,UBER   *TRIP 800-592-8996 CA 03/21,-6.78,DEBIT_CARD,16.13,
DEBIT,3/21/19,ISU LIB COFF  23058878 TERRE HAUTE IN        03/20,-2.69,DEBIT_CARD,22.91,
CREDIT,3/21/19,Online Transfer from CHK ...4842 transaction#: 8052836606,2,ACCT_XFER,25.6,
CREDIT,3/21/19,Online Transfer from CHK ...4842 transaction#: 8052512759,5,ACCT_XFER,23.6,
CREDIT,3/21/19,Online Transfer from CHK ...4842 transaction#: 8052343158,15,ACCT_XFER,18.6,
DEBIT,3/20/19,Online Transfer to CHK ...4842 transaction#: 8049297188 03/20,-49,ACCT_XFER,3.6,
DEBIT,3/20/19,THE CLASSIC MAN 812-917-2142 IN              03/19,-53.5,DEBIT_CARD,52.6,
DEBIT,3/20/19,THE CLASSIC MAN 812-917-2142 IN              03/19,-139.09,DEBIT_CARD,106.1,
CREDIT,3/20/19,Square Inc       Austi      T200105099859   CCD ID: 8800429876,50,ACH_CREDIT,245.19,
DEBIT,3/19/19,AMZN Mktp US*MW8HY2J Amzn.com/bill WA        03/19,-23.88,DEBIT_CARD,195.19,
DEBIT,3/19/19,SQC*NSBE 8774174551 CA       03/18,-1,DEBIT_CARD,219.07,
DEBIT,3/19/19,AMZN Mktp US*MW9724E Amzn.com/bill WA        03/18,-5.99,DEBIT_CARD,220.07,
CREDIT,3/19/19,Online Transfer from CHK ...4842 transaction#: 8047206686,50,ACCT_XFER,226.06,
CREDIT,3/19/19,Online Transfer from CHK ...4842 transaction#: 8047135770,139,ACCT_XFER,176.06,
DEBIT,3/18/19,AMZN Mktp US*MW3XQ1J Amzn.com/bill WA        03/18,-48.27,DEBIT_CARD,37.06,
DEBIT,3/18/19,ISU LIB COFF  23058878 TERRE HAUTE IN        03/17,-3.69,DEBIT_CARD,85.33,
CREDIT,3/18/19,Online Transfer from CHK ...4842 transaction#: 8041774969,4,ACCT_XFER,89.02,
CREDIT,3/18/19,Online Transfer from CHK ...4842 transaction#: 8043647365,30,ACCT_XFER,85.02,
CREDIT,3/18/19,Online Transfer from CHK ...4842 transaction#: 8041770703,35,ACCT_XFER,55.02,
DEBIT,3/15/19,SQC*JAWAUN T 8774174551 CA   03/14,-50,DEBIT_CARD,20.02,
DEBIT,3/14/19,ISU LIB COFF  23058878 TERRE HAUTE IN        03/13,-3.69,DEBIT_CARD,70.02,
DEBIT,3/14/19,Isu Cupboard      03/13,-1.07,DEBIT_CARD,73.71,
DEBIT,3/14/19,ISU LIB COFF  23058878 TERRE HAUTE IN        03/13,-2.59,DEBIT_CARD,74.78,
DEBIT,3/14/19,PAYPAL *SIMUNLOCKLI 4029357733               03/13,-0.99,DEBIT_CARD,77.37,
DEBIT,3/14/19,AMZN Mktp US Amzn.com/bill WA03/13,19.99,DEBIT_CARD,78.36,
DEBIT,3/13/19,Online Transfer to CHK ...4842 transaction#: 8026580605 03/13,-350,ACCT_XFER,58.37,
DEBIT,3/13/19,PAYPAL *20152923 402-935-7733 CA             03/13,-0.99,DEBIT_CARD,408.37,
DEBIT,3/13/19,PAYPAL *20152923 402-935-7733 CA             03/13,-0.99,DEBIT_CARD,409.36,
DEBIT,3/13/19,ISU LIB COFF  23058878 TERRE HAUTE IN        03/12,-0.99,DEBIT_CARD,410.35,
DEBIT,3/13/19,AMZN Mktp US*MI28X79 Amzn.com/bill WA        03/13,-36.89,DEBIT_CARD,411.34,
CREDIT,3/13/19,Online Transfer from CHK ...4842 transaction#: 8028835868,0.05,ACCT_XFER,448.23,
CREDIT,3/13/19,Online Transfer from CHK ...4842 transaction#: 8025972075,10,ACCT_XFER,448.18,
CREDIT,3/13/19,Square Inc       Austi      T200103393139   CCD ID: 8800429876,50,ACH_CREDIT,438.18,
CREDIT,3/13/19,Square Inc       Austi      T200103446719   CCD ID: 8800429876,350,ACH_CREDIT,388.18,
DEBIT,3/12/19,SQC*MARCUS SMITH 8774174551 CA               03/11,-16,DEBIT_CARD,38.18,
DEBIT,3/12/19,ISU LIB COFF  23058878 TERRE HAUTE IN        03/11,-1.38,DEBIT_CARD,54.18,
DEBIT,3/12/19,ISU LIB COFF  23058878 TERRE HAUTE IN        03/11,-3.69,DEBIT_CARD,55.56,
DEBIT,3/12/19,ISU LIB COFF  23058878 TERRE HAUTE IN        03/11,-2.69,DEBIT_CARD,59.25,
DEBIT,3/12/19,AMZN Mktp US*MW1MW3L Amzn.com/bill WA        03/11,-5.99,DEBIT_CARD,61.94,
CREDIT,3/12/19,Online Transfer from CHK ...4842 transaction#: 8024631448,1,ACCT_XFER,67.93,
CREDIT,3/12/19,Square Inc       Austi      T200103228087   CCD ID: 8800429876,1,ACH_CREDIT,66.93,
CREDIT,3/12/19,Online Transfer from CHK ...4842 transaction#: 8023422335,20,ACCT_XFER,65.93,
DEBIT,3/11/19,Online Transfer to CHK ...4842 transaction#: 8020981916 03/11,-150,ACCT_XFER,45.93,
DEBIT,3/11/19,SQC*KYLYNN 8774174551 CA     03/10,-22,DEBIT_CARD,195.93,
DEBIT,3/11/19,PAYPAL *TithesHOLDFA 402-935-7733 CA          03/09,-37.56,DEBIT_CARD,217.93,
DEBIT,3/11/19,ISU LIB COFF  23058878 TERRE HAUTE IN        03/08,-3.39,DEBIT_CARD,255.49,
DEBIT,3/11/19,ISU LIB COFF  23058878 TERRE HAUTE IN        03/08,-0.39,DEBIT_CARD,258.88,
CREDIT,3/11/19,Online Transfer from CHK ...4842 transaction#: 8019849234,22,ACCT_XFER,259.27,
CREDIT,3/11/19,Online Transfer from CHK ...4842 transaction#: 8016710167,37.36,ACCT_XFER,237.27,
CREDIT,3/11/19,Online Transfer from CHK ...4842 transaction#: 8020434935,45,ACCT_XFER,199.91,
CREDIT,3/11/19,Square Inc       Austi      T200102972348   CCD ID: 8800429876,150,ACH_CREDIT,154.91,
DEBIT,3/8/19,Online Transfer to CHK ...4842 transaction#: 8012731148 03/08,-370,ACCT_XFER,4.91,
DEBIT,3/8/19,ISU LIB COFF  23058878 TERRE HAUTE IN        03/07,-0.99,DEBIT_CARD,374.91,
DEBIT,3/8/19,ISU LIB COFF  23058878 TERRE HAUTE IN        03/07,-4.99,DEBIT_CARD,375.9,
DEBIT,3/8/19,AMZN Mktp US*MI49L7R Amzn.com/bill WA        03/07,-12.99,DEBIT_CARD,380.89,
CREDIT,3/8/19,Online Transfer from CHK ...4842 transaction#: 8013916752,1,ACCT_XFER,393.88,
CREDIT,3/8/19,Square Inc       Austi      T200102338949   CCD ID: 8800429876,160,ACH_CREDIT,392.88,
CREDIT,3/8/19,ISU PAYROLL,213.57,ACH_CREDIT,232.88,
DEBIT,3/7/19,AMZN Mktp US*MI2822U Amzn.com/bill WA        03/07,-9.99,DEBIT_CARD,19.31,
DEBIT,3/7/19,ISU LIB COFF  23058878 TERRE HAUTE IN        03/06,-3.99,DEBIT_CARD,29.3,
CREDIT,3/7/19,Online Transfer from CHK ...4842 transaction#: 8009371410,6,ACCT_XFER,33.29,
DEBIT,3/6/19,Online Transfer to CHK ...4842 transaction#: 8005684311 03/06,-50,ACCT_XFER,27.29,
DEBIT,3/6/19,ISU LIB COFF  23058878 TERRE HAUTE IN        03/05,-3.69,DEBIT_CARD,77.29,
DEBIT,3/6/19,JAMECO/JIMPAK ELECTRON 650-5928097 CA        03/04,-13.91,DEBIT_CARD,80.98,
CREDIT,3/6/19,Online Transfer from CHK ...4842 transaction#: 8006385071,4,ACCT_XFER,94.89,
CREDIT,3/6/19,Online Transfer from CHK ...4842 transaction#: 8007558390,22.98,ACCT_XFER,90.89,
CREDIT,3/6/19,Square Inc       Austi      T200101677968   CCD ID: 8800429876,50,ACH_CREDIT,67.91,
DEBIT,3/5/19,SPARKFUN ELECTRONICS NIWOT CO03/04,-23.1,DEBIT_CARD,17.91,
CREDIT,3/5/19,8003170904,4,ACCT_XFER,41.01,
CREDIT,3/5/19,8001772476,21.69,ACCT_XFER,37.01,
DEBIT,3/4/19,Amazon Prime Amzn.com/bill WA03/01,-6.49,DEBIT_CARD,15.32,
DEBIT,3/4/19,Online Transfer to SAV ...4842 transaction#: 7999890774 03/04,-17,ACCT_XFER,21.81,
DEBIT,3/4/19,Online Transfer to SAV ...4842 transaction#: 7995819013 03/04,-42,ACCT_XFER,38.81,
DEBIT,3/4/19,AMZN Mktp US*MI0C19U Amzn.com/bill WA        03/03,-19.99,DEBIT_CARD,80.81,
DEBIT,3/4/19,Amazon.com*MI2JW6XP2 Amzn.com/bill WA        03/01,-16.05,DEBIT_CARD,100.8,
CREDIT,3/4/19,7996155653,4,ACCT_XFER,116.85,
CREDIT,3/4/19,7996272410,10,ACCT_XFER,112.85,
CREDIT,3/4/19,7996152849,10,ACCT_XFER,102.85,
CREDIT,3/4/19,7996267475,15,ACCT_XFER,92.85,
CREDIT,3/4/19,Square Inc       Austi      T200101323603   CCD ID: 8800429876,15,ACH_CREDIT,77.85,
DEBIT,3/1/19,ISU LIB COFF  23058878 TERRE HAUTE IN        02/28,-3.69,DEBIT_CARD,62.85,
DEBIT,3/1/19,SQ *JORDYN STRAHAN 877-417-4551 IL           02/28,-50,DEBIT_CARD,66.54,
CREDIT,3/1/19,7987629763,40,ACCT_XFER,116.54,
CREDIT,2/28/19,7980610572,1.72,ACCT_XFER,76.54,
CREDIT,2/28/19,7984204817,4,ACCT_XFER,74.82,
CREDIT,2/28/19,7983859663,50,ACCT_XFER,70.82,
DEBIT,2/27/19,ADOBE *CREATIVE CLOUD 800-833-6687 CA        02/27,-21.39,DEBIT_CARD,20.82,
DEBIT,2/27/19,ISU LIB COFF  23058878 TERRE HAUTE IN        02/26,-1.85,DEBIT_CARD,42.21,
DEBIT,2/27/19,UAP-BONE & JOINT TERRE HAUTE IN              02/26,-30,DEBIT_CARD,44.06,
CREDIT,2/27/19,7979585897,5,ACCT_XFER,74.06,
CREDIT,2/27/19,7979066068,14,ACCT_XFER,69.06,
DEBIT,2/26/19,UBER   *TRIP A2H6Q 800-592-8996 CA           02/26,-7,DEBIT_CARD,55.06,
DEBIT,2/26/19,UBER   *TRIP FHVWE 800-592-8996 CA           02/26,-6.61,DEBIT_CARD,62.06,
DEBIT,2/26/19,UAP-ISU STUDENT HEALTH TERRE HAUTE IN        02/25,-30,DEBIT_CARD,68.67,
CREDIT,2/26/19,7975010758,10,ACCT_XFER,98.67,
CREDIT,2/26/19,7974849576,10,ACCT_XFER,88.67,
CREDIT,2/26/19,7977047836,20,ACCT_XFER,78.67,
DEBIT,2/25/19,WM SUPERCENTER # TERRE HAUTE IN      003669  02/24,-22.4,DEBIT_CARD,58.67,
DEBIT,2/25/19,PAYPAL *TithesHOLDFA 402-935-7733 CA          02/23,-43,DEBIT_CARD,81.07,
CREDIT,2/25/19,7970116667,12,ACCT_XFER,124.07,
CREDIT,2/25/19,7972913614,15,ACCT_XFER,112.07,
CREDIT,2/25/19,7969941939,22,ACCT_XFER,97.07,
CREDIT,2/25/19,7966910319,43,ACCT_XFER,75.07,
DEBIT,2/25/19,AMZN Mktp US Amzn.com/bill WA02/22,27.99,DEBIT_CARD,32.07,
DEBIT,2/22/19,Online Transfer to SAV ...4842 transaction#: 7964020019 02/22,-80,ACCT_XFER,4.08,
DEBIT,2/22/19,Online Transfer to SAV ...4842 transaction#: 7963291922 02/22,-220,ACCT_XFER,84.08,
DEBIT,2/22/19,AMZN Mktp US*MI4MK85 Amzn.com/bill WA        02/22,-11.99,DEBIT_CARD,304.08,
CREDIT,2/22/19,QuickPay with Zelle payment from KIARA L FORD 7963990220,70,QUICKPAY_CREDIT,316.07,
CREDIT,2/22/19,ISU PAYROLL,232.3,ACH_CREDIT,246.07,
DEBIT,2/21/19,REFRESHMENT SERVICES I SPRINGFIELD IL        02/21,-2.5,DEBIT_CARD,13.77,
CREDIT,2/21/19,7960667548,12,ACCT_XFER,16.27,
DEBIT,2/20/19,RMS - ISU TERRE HAUTE IN     02/19,-2.14,DEBIT_CARD,4.27,
DEBIT,2/19/19,ISU PT AND REHAB CLINI TERRE HAUTE IN        02/14,-30,DEBIT_CARD,6.41,
DEBIT,2/19/19,ISU PT AND REHAB CLINI TERRE HAUTE IN        02/12,-30,DEBIT_CARD,36.41,
DEBIT,2/15/19,SQC*KNIJA 8774174551 CA      02/14,-5,DEBIT_CARD,66.41,
DEBIT,2/15/19,AMZN Mktp US*MI9JI70 Amzn.com/bill WA        02/14,-21.95,DEBIT_CARD,71.41,
DEBIT,2/15/19,AMZN Mktp US*MI42A9F Amzn.com/bill WA        02/15,-46.32,DEBIT_CARD,93.36,
DEBIT,2/14/19,VENMO            PAYMENT    1754123783      WEB ID: 3264681992,-7,ACH_DEBIT,139.68,
DEBIT,2/14/19,AMZN Mktp US*MI5GG1T Amzn.com/bill WA        02/13,-6.99,DEBIT_CARD,146.68,
CREDIT,2/14/19,QuickPay with Zelle payment from RAMON JOSEPH HARRIS JR 7938441235,20,QUICKPAY_CREDIT,153.67,
CREDIT,2/14/19,7939617061,20,ACCT_XFER,133.67,
CREDIT,2/14/19,7937984356,68.27,ACCT_XFER,113.67,
DEBIT,2/13/19,QuickPay with Zelle payment to Ramon 7935732173,-20,QUICKPAY_DEBIT,45.4,
DEBIT,2/13/19,SQC*KYLYNN 8774174551 CA     02/12,-10,DEBIT_CARD,65.4,
CREDIT,2/13/19,7934971062,2,ACCT_XFER,75.4,
CREDIT,2/13/19,7935731074,20,ACCT_XFER,73.4,
DEBIT,2/12/19,AMZN Mktp US*MB6D06W Amzn.com/bill WA        02/12,-20.5,DEBIT_CARD,53.4,
DEBIT,2/12/19,AMZN Mktp US*MI6IJ03 Amzn.com/bill WA        02/11,-27.99,DEBIT_CARD,73.9,
DEBIT,2/12/19,AMZN Mktp US*MI33533 Amzn.com/bill WA        02/12,-22.99,DEBIT_CARD,101.89,
CREDIT,2/12/19,7932225340,6,ACCT_XFER,124.88,
CREDIT,2/12/19,7933133463,15,ACCT_XFER,118.88,
CREDIT,2/12/19,7933450678,30,ACCT_XFER,103.88,
DEBIT,2/11/19,NON-CHASE ATM FEE-WITH,-2.5,FEE_TRANSACTION,73.88,
DEBIT,2/11/19,Money Withdraw            408751  02/10550 CHEST,-29,ATM,76.38,
DEBIT,2/11/19,AMZN Mktp US*MI2DJ8N Amzn.com/bill WA        02/09,-12.99,DEBIT_CARD,105.38,
DEBIT,2/11/19,ISU PT AND REHAB CLINI TERRE HAUTE IN        02/07,-30,DEBIT_CARD,118.37,
CREDIT,2/11/19,7929277254,30,ACCT_XFER,148.37,
CREDIT,2/11/19,7929969112,70,ACCT_XFER,118.37,
DEBIT,2/8/19,Online Transfer to SAV ...4842 transaction#: 7921456297 02/08,-170,ACCT_XFER,48.37,
DEBIT,2/8/19,Girl Scouts of Centra INDIANAPOLIS IN        02/07,-25,DEBIT_CARD,218.37,
CREDIT,2/8/19,ISU PAYROLL,187.37,ACH_CREDIT,243.37,
DEBIT,2/7/19,SQC*JOHNSON KORVAH 8774174551 CA             02/06,-200,DEBIT_CARD,56,
DEBIT,2/7/19,ISU PT AND REHAB CLINI TERRE HAUTE IN        02/05,-30,DEBIT_CARD,256,
CREDIT,2/7/19,7919072056,26,ACCT_XFER,286,
CREDIT,2/7/19,7918904305,30,ACCT_XFER,260,
CREDIT,2/6/19,7916618381,200,ACCT_XFER,230,
CREDIT,2/5/19,7911644236,27.66,ACCT_XFER,30,
CREDIT,2/5/19,7912765872,30,ACCT_XFER,2.34,
DEBIT,2/4/19,QuickPay with Zelle payment to kevonteford7gmail.com 7908687364,-35,QUICKPAY_DEBIT,-27.66,
DEBIT,2/4/19,SQC*KYLYNN 8774174551 CA     02/03,-7,DEBIT_CARD,7.34,
DEBIT,2/4/19,ISU PT AND REHAB CLINI TERRE HAUTE IN        01/31,-30,DEBIT_CARD,14.34,
DEBIT,2/4/19,ISU PT AND REHAB CLINI TERRE HAUTE IN        01/29,-30,DEBIT_CARD,44.34,
CREDIT,2/4/19,7907251300,7,ACCT_XFER,74.34,
CREDIT,2/4/19,7908682463,35,ACCT_XFER,67.34,
DEBIT,2/1/19,Online Transfer to SAV ...4842 transaction#: 7898510400 02/01,-30,ACCT_XFER,32.34,
DEBIT,2/1/19,RMS - ISU TERRE HAUTE IN     01/31,-10.53,DEBIT_CARD,62.34,
DEBIT,1/31/19,Amazon Prime Amzn.com/bill WA01/31,-6.49,DEBIT_CARD,72.87,
CREDIT,1/31/19,7894269003,30,ACCT_XFER,79.36,
DEBIT,1/30/19,QuickPay with Zelle payment to Tanecia 7891727059,-10,QUICKPAY_DEBIT,49.36,
CREDIT,1/29/19,7888093440,10,ACCT_XFER,59.36,
DEBIT,1/29/19,AMZN Mktp US Amzn.com/bill WA01/28,26.99,DEBIT_CARD,49.36,
DEBIT,1/28/19,WAL-MART #1310 TERRE HAUTE IN        620094  01/28,-28.01,DEBIT_CARD,22.37,
DEBIT,1/28/19,AMZN Mktp US*MB67E92 Amzn.com/bill WA        01/28,-21.96,DEBIT_CARD,50.38,
DEBIT,1/28/19,PAYPAL *TithesHOLDFA 402-935-7733 CA          01/27,-43.65,DEBIT_CARD,72.34,
DEBIT,1/28/19,SHELL Service Station TERRE HAUTE IN 593742  01/26,-2.39,DEBIT_CARD,115.99,
DEBIT,1/25/19,Online Transfer to SAV ...4842 transaction#: 7876084672 01/25,-400,ACCT_XFER,118.38,
CREDIT,1/25/19,ISU PAYROLL,366.5,ACH_CREDIT,518.38,
DEBIT,1/24/19,Amazon.com*MB8TG7PC2 Amzn.com/bill WA        01/23,-42.08,DEBIT_CARD,151.88,
CREDIT,1/24/19,Square Inc       Austi      T20092430001    CCD ID: 8800429876,70,ACH_CREDIT,193.96,
DEBIT,1/22/19,SHELL Service Station TERRE HAUTE IN 059751  01/22,-2.39,DEBIT_CARD,123.96,
DEBIT,1/22/19,SHELL Service Station TERRE HAUTE IN 506236  01/20,-2.39,DEBIT_CARD,126.35,
DEBIT,1/22/19,AMZN Mktp US*MB73C2A Amzn.com/bill WA        01/20,-28.99,DEBIT_CARD,128.74,
DEBIT,1/22/19,PROFESSOR MESSER WWW.PROFESSOR FL            01/17,-78.45,DEBIT_CARD,157.73,
DEBIT,1/22/19,ISU PT AND REHAB CLINI TERRE HAUTE IN        01/17,-30,DEBIT_CARD,236.18,
DEBIT,1/22/19,ISU PT AND REHAB CLINI TERRE HAUTE IN        01/15,-30,DEBIT_CARD,266.18,
DEBIT,1/22/19,UDEMY ONLINE COURSES 888-838-5432 CA         01/19,11.99,DEBIT_CARD,296.18,
DEBIT,1/22/19,UDEMY ONLINE COURSES 888-838-5432 CA         01/19,11.99,DEBIT_CARD,284.19,
DEBIT,1/22/19,UDEMY ONLINE COURSES 888-838-5432 CA         01/19,11.99,DEBIT_CARD,272.2,
DEBIT,1/22/19,UDEMY ONLINE COURSES 888-838-5432 CA         01/19,11.99,DEBIT_CARD,260.21,
DEBIT,1/22/19,UDEMY ONLINE COURSES 888-838-5432 CA         01/19,11.99,DEBIT_CARD,248.22,
DEBIT,1/22/19,UDEMY ONLINE COURSES 888-838-5432 CA         01/19,11.99,DEBIT_CARD,236.23,
DEBIT,1/22/19,UDEMY ONLINE COURSES 888-838-5432 CA         01/19,11.99,DEBIT_CARD,224.24,
DEBIT,1/18/19,Online Transfer to SAV ...4842 transaction#: 7856714980 01/18,-305,ACCT_XFER,212.25,
DEBIT,1/18/19,INDIANASUVBKSTORE #52 812-237-3500 IN        01/17,-12.63,DEBIT_CARD,517.25,
DEBIT,1/18/19,VUE*COMPTIA MRKETPLCE 800-511-3478 MN        01/17,-100,DEBIT_CARD,529.88,
DEBIT,1/18/19,VUE*COMPTIA MRKETPLCE 800-511-3478 MN        01/17,-100,DEBIT_CARD,629.88,
DEBIT,1/18/19,AWL*PEARSON EDUCATION PRSONCS.COM NJ         01/18,-103.95,DEBIT_CARD,729.88,
DEBIT,1/18/19,Amazon.com*MB7VB4MP0 Amzn.com/bill WA        01/18,-14.94,DEBIT_CARD,833.83,
DEBIT,1/18/19,CHAVAS MEXICAN GRILL TERRE HAUTE IN          01/17,-9.62,DEBIT_CARD,848.77,
CREDIT,1/18/19,Square Inc       Austi      T20091316058    CCD ID: 8800429876,40,ACH_CREDIT,858.39,
DEBIT,1/16/19,UDEMY ONLINE COURSES HTTPSWWW.UDEM CA        01/15,-11.99,DEBIT_CARD,818.39,
DEBIT,1/16/19,PAYPAL *VIPOUTLET 888-792-7372 FL            01/15,-106.99,DEBIT_CARD,830.38,
DEBIT,1/15/19,UDEMY ONLINE COURSES HTTPSWWW.UDEM CA        01/14,-19.98,DEBIT_CARD,937.37,
DEBIT,1/15/19,UDEMY ONLINE COURSES HTTPSWWW.UDEM CA        01/14,-19.98,DEBIT_CARD,957.35,
DEBIT,1/15/19,Amazon.com*MB5OH7PG1 Amzn.com/bill WA        01/15,-23.26,DEBIT_CARD,977.33,
DEBIT,1/15/19,UDEMY ONLINE COURSES HTTPSWWW.UDEM CA        01/14,-98.92,DEBIT_CARD,1000.59,
DEBIT,1/15/19,AMZN Mktp US*MB0FL2P Amzn.com/bill WA        01/14,-22.95,DEBIT_CARD,1099.51,
DEBIT,1/14/19,VENMO            PAYMENT    1662517347      WEB ID: 3264681992,-305,ACH_DEBIT,1122.46,
DEBIT,1/14/19,WALGREENS STORE 1300 W TERRE HAUTE IN632752  01/13,-21.76,DEBIT_CARD,1427.46,
DEBIT,1/14/19,AMZN Mktp US*MB4S010 Amzn.com/bill WA        01/14,-26.99,DEBIT_CARD,1449.22,
DEBIT,1/14/19,PAYPAL *TithesHOLDFA 402-935-7733 CA          01/13,-161.03,DEBIT_CARD,1476.21,
DEBIT,1/14/19,TACO TEQUILAS TERRE HAUTE IN 01/11,-9.62,DEBIT_CARD,1637.24,
DEBIT,1/14/19,SQ *EMPIRE BARBERSHOP TERRE HAUTE IN         01/11,-24.15,DEBIT_CARD,1646.86,
CREDIT,1/14/19,QuickPay with Zelle payment from RAMON JOSEPH HARRIS JR 7846048558,23.36,QUICKPAY_CREDIT,1671.01,
DEBIT,1/11/19,UAP-ISU STUDENT HEALTH TERRE HAUTE IN        01/10,-53.56,DEBIT_CARD,1647.65,
CREDIT,1/11/19,Square Inc       Austi      T20089912152    CCD ID: 8800429876,80,ACH_CREDIT,1701.21,
CREDIT,1/11/19,ISU PAYROLL,213.57,ACH_CREDIT,1621.21,
CREDIT,1/9/19,INDIANA STATE UN INVOICE    PPD ID: 1356001670,1411,ACH_CREDIT,1407.64,
DEBIT,1/2/19,GREYHOUND LINES CNP 214-849-8966 TX          12/31,-55.5,DEBIT_CARD,-3.36,
DEBIT,12/31/18,Amazon Prime Amzn.com/bill WA12/31,-6.49,DEBIT_CARD,52.14,
DEBIT,12/31/18,Prime Video*M20GN3WA0 888-802-3080 WA        12/30,-3.99,DEBIT_CARD,58.63,
DEBIT,12/31/18,MARCOS PIZZA - 3566 - 812-233-8989 IN        12/30,-28.32,DEBIT_CARD,62.62,
DEBIT,12/31/18,TACO TEQUILAS TERRE HAUTE IN 12/29,-10.69,DEBIT_CARD,90.94,
DEBIT,12/28/18,TACO TEQUILAS TERRE HAUTE IN 12/27,-10.69,DEBIT_CARD,101.63,
CREDIT,12/28/18,QuickPay with Zelle payment from RAMON JOSEPH HARRIS JR 7792748788,20,QUICKPAY_CREDIT,112.32,
DEBIT,12/26/18,DENNY'S #6452 TERRE HAUTE IN         568068  12/26,-11.46,DEBIT_CARD,92.32,
DEBIT,12/26/18,QuickPay with Zelle payment to Ramon 7785786053,-20,QUICKPAY_DEBIT,103.78,
DEBIT,12/26/18,PIZZA HUT 028570 TERRE HAUTE IN              12/24,-17.55,DEBIT_CARD,123.78,
CREDIT,12/26/18,Square Inc       Austi      T20086706516    CCD ID: 8800429876,35,ACH_CREDIT,141.33,
DEBIT,12/24/18,AFFINITY STORE (SERIF) NOTTINGHAM            12/23,-39.99,DEBIT_CARD,106.33,
DEBIT,12/24/18,PAYPAL *TithesHOLDFA 402-935-7733 CA          12/23,-12.76,DEBIT_CARD,146.32,
CREDIT,12/24/18,"QuickPay with Zelle payment from CASTRO, CROSBY BAC0d795ed6b",50,PARTNERFI_TO_CHASE,159.08,
DEBIT,12/21/18,TAL INDIANAPOLIS MERRIAM KS  12/20,-1.35,DEBIT_CARD,109.08,
DEBIT,12/21/18,Amazon.com*M28O96H51 Amzn.com/bill WA        12/20,-149.79,DEBIT_CARD,110.43,
CREDIT,12/21/18,ISU PAYROLL,77.59,ACH_CREDIT,260.22,
DEBIT,12/20/18,NON-CHASE ATM FEE-INQ,-2.5,FEE_TRANSACTION,182.63,
DEBIT,12/19/18,AMZN Mktp US*M23FI40 Amzn.com/bill WA        12/19,-1.97,DEBIT_CARD,185.13,
CREDIT,12/19/18,QuickPay with Zelle payment from RAMON JOSEPH HARRIS JR 7770816004,150,QUICKPAY_CREDIT,187.1,
DEBIT,12/18/18,TAL INDIANAPOLIS MERRIAM KS  12/17,-1.35,DEBIT_CARD,37.1,
DEBIT,12/18/18,AMZN Mktp US Amzn.com/bill WA12/17,28.99,DEBIT_CARD,38.45,
DEBIT,12/17/18,VENMO 855-812-4430 NY        12/15,-10,DEBIT_CARD,9.46,
DEBIT,12/17/18,VENMO* Visa Direct NY        12/14,-90,DEBIT_CARD,19.46,
DEBIT,12/14/18,DOLLAR TREE TERRE HAUTE IN           064053  12/14,-9.63,DEBIT_CARD,109.46,
DEBIT,12/14/18,ALDI 44065 TERRE HAUTE IN            484071  12/14,-36.32,DEBIT_CARD,119.09,
DEBIT,12/14/18,WM SUPERCENTER # TERRE HAUTE IN      049134  12/14,-75.73,DEBIT_CARD,155.41,
DEBIT,12/14/18,TACO TEQUILAS TERRE HAUTE IN 12/13,-9.62,DEBIT_CARD,231.14,
CREDIT,12/14/18,ISU PAYROLL,229.57,ACH_CREDIT,240.76,
DEBIT,12/13/18,Taco Bell Fast Food,-0.39,DEBIT_CARD,11.19,
DEBIT,12/11/18,ISU BURGER KIN23023617 TERRE HAUTE IN        12/10,-2.69,DEBIT_CARD,11.58,
DEBIT,12/11/18,ISU LIB COFF  23058878 TERRE HAUTE IN        12/10,-3.69,DEBIT_CARD,14.27,
DEBIT,12/10/18,ISU LIB COFF  23058878 TERRE HAUTE IN        12/09,-0.39,DEBIT_CARD,17.96,
DEBIT,12/10/18,ISU LIB COFF  23058878 TERRE HAUTE IN        12/09,-7.38,DEBIT_CARD,18.35,
DEBIT,12/10/18,Isu Cupboard      12/08,-2.47,DEBIT_CARD,25.73,
DEBIT,12/10/18,Taco Bell Fast Food,-5,DEBIT_CARD,28.2,
DEBIT,12/7/18,Isu Cupboard      12/06,-4.95,DEBIT_CARD,33.2,
DEBIT,12/7/18,AMZN Mktp US*M03SS48 Amzn.com/bill WA        12/07,-32.99,DEBIT_CARD,38.15,
CREDIT,12/6/18,Square Inc       Austi      T20082960942    CCD ID: 8800429876,70,ACH_CREDIT,71.14,
DEBIT,12/5/18,DENNY'S #6452 TERRE HAUTE IN         806699  12/05,-4.63,DEBIT_CARD,1.14,
DEBIT,12/5/18,AMZN Mktp US*M05PM5H Amzn.com/bill WA        12/05,-57.98,DEBIT_CARD,5.77,
DEBIT,12/3/18,REFRESHMENT SERVICES I SPRINGFIELD IL        12/02,-1.5,DEBIT_CARD,63.75,
DEBIT,12/3/18,REFRESHMENT SERVICES I SPRINGFIELD IL        12/02,-1.5,DEBIT_CARD,65.25,
DEBIT,12/3/18,PAYPAL *TithesHOLDFA 402-935-7733 CA          12/02,-11,DEBIT_CARD,66.75,
CREDIT,12/3/18,Square Inc       Austi      T20081692989    CCD ID: 8800429876,30,ACH_CREDIT,77.75,
DEBIT,11/30/18,Amazon Prime Amzn.com/bill WA11/30,-6.49,DEBIT_CARD,47.75,
DEBIT,11/30/18,VENMO* Visa Direct NY        11/30,-210,DEBIT_CARD,54.24,
CREDIT,11/30/18,ISU PAYROLL,109.84,ACH_CREDIT,264.24,
CREDIT,11/28/18,Square Inc       Austi      T20081006298    CCD ID: 8800429876,40,ACH_CREDIT,154.4,
DEBIT,11/27/18,PAYPAL *TithesHOLDFA 402-935-7733 CA          11/27,-30,DEBIT_CARD,114.4,
CREDIT,11/27/18,QuickPay with Zelle payment from ZAVION T BROWN 7700503924,100,QUICKPAY_CREDIT,144.4,
DEBIT,11/26/18,WENDYS TERRE HAUTE-WAL TERRE HAUTE IN        11/25,-4.32,DEBIT_CARD,44.4,
DEBIT,11/26/18,AMZN Mktp US*M07G20Z Amzn.com/bill WA        11/23,-36.99,DEBIT_CARD,48.72,
DEBIT,11/21/18,QuickPay with Zelle payment to Jairus Stevens 7685063962,-50,QUICKPAY_DEBIT,85.71,
DEBIT,11/20/18,VENMO 855-812-4430 NY        11/19,-70,DEBIT_CARD,135.71,
DEBIT,11/19/18,AMZN Mktp US*M87N71Y Amzn.com/bill WA        11/18,-285.84,DEBIT_CARD,205.71,
DEBIT,11/19/18,Amazon.com*M84TI2W11 Amzn.com/bill WA        11/18,-52.57,DEBIT_CARD,491.55,
DEBIT,11/19/18,NATIONAL SOCIETY OF B 703-837-9906 VA        11/16,-15,DEBIT_CARD,544.12,
DEBIT,11/19/18,SHIRTMAX 402-935-7733 GA     11/17,182.1,DEBIT_CARD,559.12,
DEBIT,11/16/18,TAL INDIANAPOLIS MERRIAM KS  11/15,-1.35,DEBIT_CARD,377.02,
DEBIT,11/16/18,VENMO*Castro Austin NEW YORK CITY NY 865071  11/16,39.6,DEBIT_CARD,378.37,
CREDIT,11/16/18,ISU PAYROLL,260.01,ACH_CREDIT,338.77,
DEBIT,11/15/18,ISU LIB COFF  23058878 TERRE HAUTE IN        11/14,-7.38,DEBIT_CARD,78.76,
DEBIT,11/14/18,SQC*MAHOGANY HARTS 8774174551 CA             11/13,-45,DEBIT_CARD,86.14,
DEBIT,11/14/18,SQC*NSBE 8774174551 CA       11/13,-5,DEBIT_CARD,131.14,
DEBIT,11/14/18,TAL INDIANAPOLIS MERRIAM KS  11/13,-1.35,DEBIT_CARD,136.14,
DEBIT,11/13/18,SILVER MOUNTAIN GRAPH 502-498-4455 KY        11/08,-194.06,DEBIT_CARD,137.49,
CREDIT,11/13/18,Square Inc       Austi      T20077562518    CCD ID: 8800429876,80,ACH_CREDIT,331.55,
DEBIT,11/13/18,AMZN Mktp US Amzn.com/bill WA11/09,21.38,DEBIT_CARD,251.55,
DEBIT,11/13/18,AMZN Mktp US Amzn.com/bill WA11/11,29.99,DEBIT_CARD,230.17,
DEBIT,11/9/18,WM SUPERCENTER # TERRE HAUTE IN      064370  11/09,-47.09,DEBIT_CARD,200.18,
DEBIT,11/9/18,ISU LIB COFF  23058878 TERRE HAUTE IN        11/08,-3.69,DEBIT_CARD,247.27,
DEBIT,11/8/18,QuickPay with Zelle payment to Zavion Brown 7648726601,-13,QUICKPAY_DEBIT,250.96,
DEBIT,11/8/18,TAL INDIANAPOLIS MERRIAM KS  11/06,-1.35,DEBIT_CARD,263.96,
DEBIT,11/7/18,Isu Cupboard      11/06,-4.95,DEBIT_CARD,265.31,
DEBIT,11/7/18,ISU LIB COFF  23058878 TERRE HAUTE IN        11/06,-3.69,DEBIT_CARD,270.26,
DEBIT,11/7/18,AMZN Mktp US*M873D4B Amzn.com/bill WA        11/07,-28.99,DEBIT_CARD,273.95,
CREDIT,11/7/18,Square Inc       Austi      T20076953379    CCD ID: 8800429876,15,ACH_CREDIT,302.94,
DEBIT,11/6/18,QuickPay with Zelle payment to Zavion Brown 7643225040,-4,QUICKPAY_DEBIT,287.94,
DEBIT,11/6/18,SHIRTMAX 402-935-7733 GA     11/05,-182.1,DEBIT_CARD,291.94,
CREDIT,11/6/18,Square Inc       Austi      T20076761816    CCD ID: 8800429876,60,ACH_CREDIT,474.04,
DEBIT,11/6/18,VENMO*Castro Austin NEW YORK CITY NY 879429  11/06,99.75,DEBIT_CARD,414.04,
DEBIT,11/5/18,PAYPAL *TithesHOLDFA 402-935-7733 CA          11/05,-31.1,DEBIT_CARD,314.29,
DEBIT,11/2/18,ISU LIB COFF  23058878 TERRE HAUTE IN        11/01,-3.29,DEBIT_CARD,345.39,
CREDIT,11/2/18,ISU PAYROLL,241.28,ACH_CREDIT,348.68,
DEBIT,11/1/18,Isu Cupboard      11/01,-2.47,DEBIT_CARD,107.4,
DEBIT,11/1/18,TAL INDIANAPOLIS MERRIAM KS  10/31,-1.35,DEBIT_CARD,109.87,
DEBIT,11/1/18,AMZN Mktp US*M87CU9G Amzn.com/bill WA        10/31,-17.99,DEBIT_CARD,111.22,
DEBIT,10/31/18,Amazon Prime Amzn.com/bill WA10/31,-6.49,DEBIT_CARD,129.21,
DEBIT,10/31/18,TAL INDIANAPOLIS MERRIAM KS  10/30,-1.35,DEBIT_CARD,135.7,
DEBIT,10/30/18,Isu Cupboard      10/30,-1.89,DEBIT_CARD,137.05,
DEBIT,10/30/18,AMZN Mktp US*M80B871 Amzn.com/bill WA        10/30,-75.21,DEBIT_CARD,138.94,
DEBIT,10/29/18,ISU LIB COFF  23058878 TERRE HAUTE IN        10/28,-3.69,DEBIT_CARD,214.15,
DEBIT,10/29/18,AMZN Mktp US*M897A2E Amzn.com/bill WA        10/28,-24.99,DEBIT_CARD,217.84,
DEBIT,10/29/18,VENMO* Visa Direct NY        10/27,-150,DEBIT_CARD,242.83,
DEBIT,10/26/18,AMZN Mktp US*M885Y1T Amzn.com/bill WA        10/25,-21.38,DEBIT_CARD,392.83,
DEBIT,10/26/18,AMZN Mktp US*M85KS1T Amzn.com/bill WA        10/25,-21.94,DEBIT_CARD,414.21,
DEBIT,10/25/18,ISU STALKER HA23058886 TERRE HAUTE IN        10/24,-1.49,DEBIT_CARD,436.15,
DEBIT,10/25/18,PAYPAL *TithesHOLDFA 402-935-7733 CA          10/24,-100,DEBIT_CARD,437.64,
DEBIT,10/25/18,VENMO*Castro Austin NEW YORK CITY NY 832096  10/25,99.75,DEBIT_CARD,537.64,
DEBIT,10/24/18,ISU LIB COFF  23058878 TERRE HAUTE IN        10/23,-3.69,DEBIT_CARD,437.89,
DEBIT,10/23/18,SHELL Service Station TERRE HAUTE IN 267655  10/23,-3.21,DEBIT_CARD,441.58,
DEBIT,10/23/18,TAL INDIANAPOLIS MERRIAM KS  10/22,-1.35,DEBIT_CARD,444.79,
DEBIT,10/22/18,PAYPAL *TithesHOLDFA 402-935-7733 CA          10/20,-38,DEBIT_CARD,446.14,
DEBIT,10/22/18,RMS - ISU TERRE HAUTE IN     10/19,-6.14,DEBIT_CARD,484.14,
CREDIT,10/19/18,ISU PAYROLL,272.49,ACH_CREDIT,490.28,
CREDIT,10/18/18,Square Inc       Austi      T20072922576    CCD ID: 8800429876,25,ACH_CREDIT,217.79,
CREDIT,10/18/18,APPLE PAY CASH   TRANSFER   4EKNE82ANRTHT3O WEB ID: 6192912998,35,ACH_CREDIT,192.79,
DEBIT,10/17/18,ISU LIB COFF  23058878 TERRE HAUTE IN        10/16,-5.98,DEBIT_CARD,157.79,
DEBIT,10/15/18,PAYPAL *TithesHOLDFA 402-935-7733 CA          10/15,-10,DEBIT_CARD,163.77,
DEBIT,10/15/18,AMZN Mktp US*MT6H07I Amzn.com/bill WA        10/15,-35.99,DEBIT_CARD,173.77,
DEBIT,10/15/18,RMS - ISU TERRE HAUTE IN     10/12,-6.14,DEBIT_CARD,209.76,
CREDIT,10/15/18,Square Inc       Austi      T20072186833    CCD ID: 8800429876,40,ACH_CREDIT,215.9,
DEBIT,10/11/18,AMZN Mktp US*MT7Q727 Amzn.com/bill WA        10/11,-18.99,DEBIT_CARD,175.9,
CREDIT,10/11/18,Square Inc       Austi      T20071479329    CCD ID: 8800429876,65,ACH_CREDIT,194.89,
DEBIT,10/9/18,WAL-MART #1310 TERRE HAUTE IN        327419  10/08,-39.52,DEBIT_CARD,129.89,
DEBIT,10/9/18,ISU LIB COFF  23058878 TERRE HAUTE IN        10/08,-2.72,DEBIT_CARD,169.41,
DEBIT,10/9/18,AMZN Mktp US*MT59T8S Amzn.com/bill WA        10/08,-21.95,DEBIT_CARD,172.13,
DEBIT,10/9/18,PAYPAL *TithesHOLDFA 402-935-7733 CA          10/07,-20,DEBIT_CARD,194.08,
DEBIT,10/9/18,AMZN Mktp US*MT25N2S Amzn.com/bill WA        10/06,-14.65,DEBIT_CARD,214.08,
DEBIT,10/9/18,AMZN Mktp US*MT9RF5D Amzn.com/bill WA        10/05,-19.83,DEBIT_CARD,228.73,
DEBIT,10/9/18,AMZN Mktp US*MT22Z47 Amzn.com/bill WA        10/06,-15.85,DEBIT_CARD,248.56,
CREDIT,10/5/18,ISU PAYROLL,190.7,ACH_CREDIT,264.41,
DEBIT,10/4/18,AMZN Mktp US*MT2O10Q Amzn.com/bill WA        10/04,-9.99,DEBIT_CARD,73.71,
DEBIT,10/3/18,DENNY'S #6452 TERRE HAUTE IN         251330  10/02,-8.63,DEBIT_CARD,83.7,
DEBIT,10/3/18,AMZN Mktp US*MT77T38 Amzn.com/bill WA        10/03,-34.99,DEBIT_CARD,92.33,
DEBIT,10/3/18,AMZN Mktp US*MT7O26Q Amzn.com/bill WA        10/03,-14.95,DEBIT_CARD,127.32,
DEBIT,10/3/18,Fast Food MCF11572 TERRE HAUTE IN             10/02,-5.61,DEBIT_CARD,142.27,
DEBIT,10/3/18,AMZN Mktp US Amzn.com/bill WA10/03,22.99,DEBIT_CARD,147.88,
DEBIT,10/3/18,AMZN Mktp US Amzn.com/bill WA10/03,35.99,DEBIT_CARD,124.89,
DEBIT,10/2/18,PARCHMENT - UNIV DOCS 480-719-1646 AZ        10/02,-10,DEBIT_CARD,88.9,
DEBIT,10/2/18,SQC*NOAH COLLINSWOR 8774174551 CA            10/01,-10,DEBIT_CARD,98.9,
DEBIT,10/2/18,AMZN Mktp US*MT1984B Amzn.com/bill WA        10/02,-18.99,DEBIT_CARD,108.9,
DEBIT,10/2/18,RMS - ISU TERRE HAUTE IN     10/01,-6.14,DEBIT_CARD,127.89,
DEBIT,10/1/18,Amazon Prime Amzn.com/bill WA09/30,-6.49,DEBIT_CARD,134.03,
DEBIT,10/1/18,CVS/PHARMACY #06 06684 TERRE HAUTE IN646351  10/01,-12.25,DEBIT_CARD,140.52,
CREDIT,10/1/18,Square Inc       Austi      T20068897916    CCD ID: 8800429876,40,ACH_CREDIT,152.77,
DEBIT,9/28/18,AMZN Mktp US*MT7YJ0V Amzn.com/bill WA        09/28,-28.99,DEBIT_CARD,112.77,
DEBIT,9/27/18,Amazon.com*MT8471PE0 Amzn.com/bill WA        09/26,-80.73,DEBIT_CARD,141.76,
DEBIT,9/26/18,VISIONWORKS 864 HIGHLAND IN  09/25,-248.36,DEBIT_CARD,222.49,
DEBIT,9/25/18,CVS/PHARMACY #06 06684 TERRE HAUTE IN902366  09/25,-15.33,DEBIT_CARD,470.85,
DEBIT,9/25/18,AMZN Mktp US*MT9KK7A Amzn.com/bill WA        09/25,-13.94,DEBIT_CARD,486.18,
DEBIT,9/25/18,AMZN Mktp US*MT6WM6A Amzn.com/bill WA        09/24,-22.99,DEBIT_CARD,500.12,
DEBIT,9/25/18,AMZN Mktp US*MT2A73A Amzn.com/bill WA        09/24,-22.99,DEBIT_CARD,523.11,
CREDIT,9/25/18,Square Inc       Austi      T20068061490    CCD ID: 8800429876,168,ACH_CREDIT,546.1,
DEBIT,9/24/18,PAYPAL *TithesHOLDFA 402-935-7733 CA          09/24,-100,DEBIT_CARD,378.1,
DEBIT,9/24/18,AMZN Mktp US*MT6ZH7A Amzn.com/bill WA        09/24,-35.99,DEBIT_CARD,478.1,
DEBIT,9/24/18,AMZN Mktp US*MT3XA30 Amzn.com/bill WA        09/24,-35.99,DEBIT_CARD,514.09,
DEBIT,9/24/18,PAYPAL *TithesHOLDFA 402-935-7733 CA          09/23,-22.1,DEBIT_CARD,550.08,
CREDIT,9/21/18,ISU PAYROLL,143.31,ACH_CREDIT,572.18,
CREDIT,9/21/18,QuickPay with Zelle payment from RAMON JOSEPH HARRIS JR 7506432490,200,QUICKPAY_CREDIT,428.87,
DEBIT,9/19/18,QuickPay with Zelle payment to Ramon 7500530852,-20,QUICKPAY_DEBIT,228.87,
DEBIT,9/19/18,QuickPay with Zelle payment to Ramon 7500523101,-180,QUICKPAY_DEBIT,248.87,
DEBIT,9/19/18,AWL*PEARSON EDUCATION PRSONCS.COM NJ         09/19,-41.72,DEBIT_CARD,428.87,
DEBIT,9/18/18,AMZN Mktp US*MT6UB7Z Amzn.com/bill WA        09/18,-5.18,DEBIT_CARD,470.59,
DEBIT,9/17/18,WAL-MART #1310 TERRE HAUTE IN        548171  09/16,-3.79,DEBIT_CARD,475.77,
DEBIT,9/17/18,AFFINITY STORE (SERIF) NOTTINGHAM            09/16,-49.99,DEBIT_CARD,479.56,
DEBIT,9/17/18,PAYPAL *TithesHOLDFA 402-935-7733 CA          09/16,-20,DEBIT_CARD,529.55,
DEBIT,9/13/18,Amazon.com*MT0YB3451 Amzn.com/bill WA        09/13,-14.25,DEBIT_CARD,549.55,
DEBIT,9/13/18,AMZN Mktp US*MT9649L Amzn.com/bill WA        09/13,-10.96,DEBIT_CARD,563.8,
DEBIT,9/11/18,ETRADESUPPL 402-935-7733 MI  09/11,-167.4,DEBIT_CARD,574.76,
DEBIT,9/10/18,PAYPAL *TithesHOLDFA 402-935-7733 CA          09/08,-33.1,DEBIT_CARD,742.16,
CREDIT,9/10/18,Square Inc       Austi      T20065294281    CCD ID: 8800429876,5,ACH_CREDIT,775.26,
CREDIT,9/10/18,Square Inc       Austi      T20064822841    CCD ID: 8800429876,80,ACH_CREDIT,770.26,
CREDIT,9/10/18,Square Inc       Austi      T20065280102    CCD ID: 8800429876,123,ACH_CREDIT,690.26,
DEBIT,9/7/18,INDIANASUVBKSTORE #52 812-237-3500 IN        09/06,-181.85,DEBIT_CARD,567.26,
CREDIT,9/7/18,ISU PAYROLL,171.35,ACH_CREDIT,749.11,
DEBIT,9/6/18,SQC*TRISTIAN 8774174551 CA   09/05,-20,DEBIT_CARD,577.76,
DEBIT,9/4/18,WAL Wal-Mart Super 251 TERRE HAUTE IN814836  09/04,-46.07,DEBIT_CARD,597.76,
DEBIT,9/4/18,CHAVAS MEXICAN GRILL TERRE HAUTE IN          09/03,-9.62,DEBIT_CARD,643.83,
DEBIT,9/4/18,ETRADESUPPL 402-935-7733 MI  09/03,-162.88,DEBIT_CARD,653.45,
DEBIT,9/4/18,AMZN Mktp US Amzn.com/bill WA09/04,-22.75,DEBIT_CARD,816.33,
DEBIT,9/4/18,Amazon.com Amzn.com/bill WA  09/02,-13,DEBIT_CARD,839.08,
DEBIT,9/4/18,Amazon.com Amzn.com/bill WA  09/02,-51.35,DEBIT_CARD,852.08,
DEBIT,9/4/18,ISRAEL GOD 402-935-7733 IL   09/02,-42.66,DEBIT_CARD,903.43,
DEBIT,9/4/18,VISTAPR*VistaPrint.com 866-8936743 MA        09/02,-11.73,DEBIT_CARD,946.09,
DEBIT,9/4/18,Fast Food MCF11572 TERRE HAUTE IN             09/01,-7,DEBIT_CARD,957.82,
DEBIT,9/4/18,BKST-INDIANA-S-UV #524 TERRE HAUTE IN        08/31,-85.65,DEBIT_CARD,964.82,
DEBIT,9/4/18,APPLE PAY - SENT MONE 877-233-8552 CA        08/31,-60,DEBIT_CARD,1050.47,
DEBIT,9/4/18,BKST-INDIANA-S-UV #524 TERRE HAUTE IN        08/31,85.65,DEBIT_CARD,1110.47,
DEBIT,8/31/18,Amazon Prime Amzn.com/bill WA08/31,-6.49,DEBIT_CARD,1024.82,
DEBIT,8/31/18,QuickPay with Zelle payment to Sarita Stevens 7445578308,-360,QUICKPAY_DEBIT,1031.31,
CREDIT,8/31/18,INDIANA STATE UN INVOICE    PPD ID: 1356001670,1382.18,ACH_CREDIT,1391.31,
DEBIT,8/27/18,CELLULAR REPAIR SCHOOL 855-3381277 AZ        08/26,-7,DEBIT_CARD,9.13,
DEBIT,8/27/18,PAYPAL *TithesHOLDFA 402-935-7733 CA          08/26,-7,DEBIT_CARD,16.13,
DEBIT,8/27/18,AMZN Mktp US Amzn.com/bill WA08/26,-33.99,DEBIT_CARD,23.13,
CREDIT,8/24/18,QuickPay with Zelle payment from DANIELLE S LEWIS 7429510109,70,QUICKPAY_CREDIT,57.12,
DEBIT,8/23/18,AMZN Mktp US Amzn.com/bill WA08/22,12,DEBIT_CARD,-12.88,
DEBIT,8/20/18,SHARKS FISH AND CHICK MERRILLVILLE IN        08/17,-8.55,DEBIT_CARD,-24.88,
DEBIT,8/20/18,DUNKIN #301651 Q35 MERRILLVILLE IN           08/17,-3.01,DEBIT_CARD,-16.33,
DEBIT,8/20/18,POPS ITALIAN BEEF SA 219-6639801 IN          08/16,-17.82,DEBIT_CARD,-13.32,
DEBIT,8/20/18,AMZN Mktp US Amzn.com/bill WA08/19,-27.39,DEBIT_CARD,4.5,
DEBIT,8/16/18,DOLLAR GENERAL # MERRILLVILLE IN     000628  08/16,-1.07,DEBIT_CARD,31.89,
DEBIT,8/16/18,MEIJER # 165 611 W LI MERRILLVILLE IN759357  08/16,-13.43,DEBIT_CARD,32.96,
CREDIT,8/15/18,Square Inc       Austi      T20060305449    CCD ID: 8800429876,10,ACH_CREDIT,46.39,
DEBIT,8/13/18,AMZN Mktp US Amzn.com/bill WA08/12,-27.99,DEBIT_CARD,36.39,
DEBIT,8/10/18,Microsoft *Xbox msbill.info WA               08/10,-16.04,DEBIT_CARD,64.38,
DEBIT,8/10/18,AMZN Mktp US Amzn.com/bill WA08/09,-9.99,DEBIT_CARD,80.42,
DEBIT,8/10/18,AMZN Mktp US Amzn.com/bill WA08/09,-6.89,DEBIT_CARD,90.41,
CREDIT,8/10/18,QuickPay with Zelle payment from SARITA A STEVENS 7390676938,75,QUICKPAY_CREDIT,97.3,
CREDIT,8/9/18,QuickPay with Zelle payment from RAMON JOSEPH HARRIS JR 7385562777,10,QUICKPAY_CREDIT,22.3,
DEBIT,8/8/18,AMZN Mktp US Amzn.com/bill WA08/07,-8.95,DEBIT_CARD,12.3,
DEBIT,8/7/18,AMZN Mktp US Amzn.com/bill WA08/07,-34.99,DEBIT_CARD,21.25,
CREDIT,8/7/18,Square Inc       Austi      T20058876850    CCD ID: 8800429876,20,ACH_CREDIT,56.24,
DEBIT,8/6/18,AMZN Mktp US Amzn.com/bill WA08/06,-16.2,DEBIT_CARD,36.24,
DEBIT,8/6/18,STARDUST BOWL II MERRILLVILLE IN             08/04,-4.5,DEBIT_CARD,52.44,
DEBIT,8/6/18,STARDUST BOWL II MERRILLVILLE IN             08/04,-4.5,DEBIT_CARD,56.94,
DEBIT,8/6/18,STARDUST BOWL II MERRILLVILLE IN             08/04,-8.23,DEBIT_CARD,61.44,
CREDIT,8/6/18,QuickPay with Zelle payment from RAMON JOSEPH HARRIS JR 7375298800,5,QUICKPAY_CREDIT,69.67,
CREDIT,8/6/18,QuickPay with Zelle payment from RAMON JOSEPH HARRIS JR 7375671211,8.95,QUICKPAY_CREDIT,64.67,
CREDIT,8/6/18,QuickPay with Zelle payment from RAMON JOSEPH HARRIS JR 7375664908,15,QUICKPAY_CREDIT,55.72,
DEBIT,8/3/18,AMZN Mktp US Amzn.com/bill WA08/02,36.99,DEBIT_CARD,40.72,
DEBIT,8/2/18,FIXEZ.COM 866-233-6460 NV    08/01,-89.05,DEBIT_CARD,3.73,
DEBIT,8/1/18,PAYPAL *DORIANBURNS 402-935-7733 CA          07/31,-130,DEBIT_CARD,92.78,
DEBIT,8/1/18,AMZN Mktp US Amzn.com/bill WA07/31,-36.99,DEBIT_CARD,222.78,
DEBIT,8/1/18,PAYPAL *TithesHOLDFA 402-935-7733 CA          07/30,-6,DEBIT_CARD,259.77,
DEBIT,7/31/18,AmazonPrime Membersh amzn.com/prme WA        07/31,-6.49,DEBIT_CARD,265.77,
CREDIT,7/31/18,QuickPay with Zelle payment from RAMON JOSEPH HARRIS JR 7359293314,5.3,QUICKPAY_CREDIT,272.26,
CREDIT,7/31/18,QuickPay with Zelle payment from RAMON JOSEPH HARRIS JR 7359202709,70.92,QUICKPAY_CREDIT,266.96,
CREDIT,7/31/18,QuickPay with Zelle payment from RAMON JOSEPH HARRIS JR 7359247882,130,QUICKPAY_CREDIT,196.04,
DEBIT,7/25/18,Amazon         07/24,7.5,DEBIT_CARD,66.04,
DEBIT,7/25/18,Amazon         07/24,29.98,DEBIT_CARD,58.54,
DEBIT,7/24/18,WITHDRAWAL 07/24,-100,MISC_DEBIT,28.56,
CREDIT,7/24/18,QuickPay with Zelle payment from KAREN L TYSON 7339691661,100,QUICKPAY_CREDIT,128.56,
CREDIT,7/24/18,Reversal: DRIVERSLICENSES.ORG 855-2050454 MA           07/20  ClaimId: 984408383710001,3.99,ATM,28.56,
CREDIT,7/24/18,Reversal: DRIVERSLICENSES.ORG 855-2050454 MA           07/22  ClaimId: 984408383710001,19.99,ATM,24.57,
DEBIT,7/23/18,DRIVERSLICENSES.ORG 855-2050454 MA           07/22,-19.99,DEBIT_CARD,4.58,
DEBIT,7/23/18,PAYPAL *TithesHOLDFA 402-935-7733 CA          07/20,-3,DEBIT_CARD,24.57,
DEBIT,7/23/18,DRIVERSLICENSES.ORG 855-2050454 MA           07/20,-3.99,DEBIT_CARD,27.57,
DEBIT,7/19/18,STRACK & VAN TIL #8797 CROWN POINT IN        07/18,-3.41,DEBIT_CARD,31.56,
DEBIT,7/17/18,ATM WITHDRAWAL       003127  07/171837 E 80,-220,ATM,34.97,
CREDIT,7/17/18,QuickPay with Zelle payment from KAREN L TYSON 7322926744,250,QUICKPAY_CREDIT,254.97,
DEBIT,7/10/18,PIZZA HUT 032409 MERRILLVILLE IN             07/09,-32.16,DEBIT_CARD,4.97,
DEBIT,7/9/18,PHILLY STEAK &LEMONAD 219-472-0034 IN        07/08,-28.24,DEBIT_CARD,37.13,
DEBIT,7/9/18,WENDY S #331 MERRILLVILLE IN 07/07,-16.77,DEBIT_CARD,65.37,
CREDIT,7/9/18,"QuickPay with Zelle payment from CASTRO, CROSBY 7296026024",80,PARTNERFI_TO_CHASE,82.14,
DEBIT,7/6/18,Walgreens Groceries IN800589  07/06,-2.13,DEBIT_CARD,2.14,
DEBIT,7/3/18,ADOBE *CREATIVE CLOUD 800-833-6687 CA        07/03,-21.39,DEBIT_CARD,4.27,
DEBIT,7/3/18,LOWE'S #1569 MERRILLVILLE IN         624935  07/03,-8.01,DEBIT_CARD,25.66,
DEBIT,7/3/18,WENDY S #331 MERRILLVILLE IN 07/02,-18.9,DEBIT_CARD,33.67,
DEBIT,7/2/18,ADOBE *CREATIVE CLOUD 800-833-6687 CA        07/02,-21.39,DEBIT_CARD,52.57,
DEBIT,7/2/18,Walgreens Groceries IN355784  07/01,-3.23,DEBIT_CARD,73.96,
DEBIT,7/2/18,PAYPAL *GADGETORY 402-935-7733 CA            06/30,-170,DEBIT_CARD,77.19,
DEBIT,7/2/18,PAYPAL *TithesHOLDFA 402-935-7733 CA          06/30,-27.48,DEBIT_CARD,247.19,
DEBIT,6/29/18,BWW 3354 HOBART HOBART IN    06/28,-10.48,DEBIT_CARD,274.67,
CREDIT,6/28/18,ATM CASH DEPOSIT 06/28 6790 BROADWAY MERRILLVILLE IN,242,ATM,285.15,
DEBIT,6/27/18,MICROSOFT   *XBOX MSBILL.INFO WA             06/26,-21.21,DEBIT_CARD,43.15,
DEBIT,6/27/18,Amazon         06/27,-37.48,DEBIT_CARD,64.36,
DEBIT,6/27/18,STRACK & VAN TIL #8797 CROWN POINT IN        06/26,-42.2,DEBIT_CARD,101.84,
DEBIT,6/27/18,WU GM FINANCIAL 800-284-2271 TX              06/27,-32.5,DEBIT_CARD,144.04,
DEBIT,6/27/18,Amazon         06/26,29.99,DEBIT_CARD,176.54,
DEBIT,6/26/18,FAMILY EXPRESS #57 MERRILLVILLE IN   919964  06/26,-10,DEBIT_CARD,146.55,
DEBIT,6/26/18,ALDI 62025 CROWN POINT IN            856383  06/26,-147.41,DEBIT_CARD,156.55,
DEBIT,6/26/18,DOLLAR TREE CROWN POINT IN           032682  06/26,-23.4,DEBIT_CARD,303.96,
DEBIT,6/25/18,Walgreens Groceries IN115901  06/25,-1.07,DEBIT_CARD,327.36,
DEBIT,6/25/18,Walgreens Groceries IN110237  06/25,-5.98,DEBIT_CARD,328.43,
DEBIT,6/25/18,PAYPAL *TithesHOLDFA 402-935-7733 CA          06/24,-23.3,DEBIT_CARD,334.41,
DEBIT,6/25/18,MEIJER # 165 611 W LI MERRILLVILLE IN961367  06/24,-13.78,DEBIT_CARD,357.71,
DEBIT,6/25/18,Walgreens Groceries IN614998  06/24,-0.07,DEBIT_CARD,371.49,
DEBIT,6/25/18,Amazon         06/22,-4.64,DEBIT_CARD,371.56,
DEBIT,6/22/18,APPLEBEES 077 9829160 MERRILLVILLE IN        06/21,-35.3,DEBIT_CARD,376.2,
CREDIT,6/22/18,INTEGRITY TRADE  PAYROLL    PPD ID: 1263211008,233.38,ACH_CREDIT,411.5,
DEBIT,6/21/18,PIZZA HUT 032409 MERRILLVILLE IN             06/20,-26.74,DEBIT_CARD,178.12,
DEBIT,6/20/18,TRIPPLE S CITGO MERRILLVILLE IN      832418  06/20,-5,DEBIT_CARD,204.86,
DEBIT,6/20/18,Amazon         06/20,-30.95,DEBIT_CARD,209.86,
DEBIT,6/20/18,Amazon         06/20,-37.84,DEBIT_CARD,240.81,
DEBIT,6/19/18,Walgreens Groceries IN028868  06/19,-9.18,DEBIT_CARD,278.65,
DEBIT,6/18/18,MNRD-MERRILLVLE 6300 MERRILLVILLE IN 649172  06/18,-2.94,DEBIT_CARD,287.83,
DEBIT,6/18/18,TARGET T-0870 2661 E MERRILLVILLE IN 857418  06/18,-9.62,DEBIT_CARD,290.77,
DEBIT,6/18/18,MEIJER # 165 611 W LI MERRILLVILLE IN208571  06/17,-2.5,DEBIT_CARD,300.39,
DEBIT,6/18/18,PAYPAL *TithesHOLDFA 402-935-7733 CA          06/16,-27.42,DEBIT_CARD,302.89,
DEBIT,6/18/18,SUBWAY        00296137 HAMMOND IN            06/15,-5.48,DEBIT_CARD,330.31,
CREDIT,6/18/18,ATM CASH DEPOSIT 06/17 6790 BROADWAY MERRILLVILLE IN,50,ATM,335.79,
DEBIT,6/15/18,MEIJER # 165 611 W LI MERRILLVILLE IN502129  06/15,-2.99,DEBIT_CARD,285.79,
CREDIT,6/15/18,INTEGRITY TRADE  PAYROLL    PPD ID: 1263211008,274.21,ACH_CREDIT,288.78,
DEBIT,6/13/18,DOLLAR TREE MERRILLVILLE IN          000972  06/13,-1.07,DEBIT_CARD,14.57,
DEBIT,6/13/18,USCONNECT CLVND VEND S CEDAR LAKE IN         06/12,-1.1,DEBIT_CARD,15.64,
DEBIT,6/12/18,GOLO GAS AND FOOD EAST CHICAGO IN    007264  06/12,-10,DEBIT_CARD,16.74,
DEBIT,6/11/18,Amazon         06/11,-23.98,DEBIT_CARD,26.74,
DEBIT,6/11/18,STRACK & VAN TIL #8797 CROWN POINT IN        06/10,-25.16,DEBIT_CARD,50.72,
DEBIT,6/11/18,ATM WITHDRAWAL       006866  06/106790 BROA,-300,ATM,75.88,
DEBIT,6/11/18,USCONNECT CLVND VEND S CEDAR LAKE IN         06/08,-1.1,DEBIT_CARD,375.88,
DEBIT,6/11/18,USCONNECT CLVND VEND S CEDAR LAKE IN         06/08,-1.1,DEBIT_CARD,376.98,
CREDIT,6/11/18,QuickPay with Zelle payment from RAMON JOSEPH HARRIS JR 7220379175,75,QUICKPAY_CREDIT,378.08,
CREDIT,6/11/18,QuickPay with Zelle payment from KAREN L TYSON 7220515181,300,QUICKPAY_CREDIT,303.08,
DEBIT,6/8/18,USCONNECT CLVND VEND S CEDAR LAKE IN         06/07,-1.35,DEBIT_CARD,3.08,
DEBIT,6/6/18,LUKE 273 MERRILLVILLE IN             710208  06/06,-20,DEBIT_CARD,4.43,
DEBIT,6/5/18,Amazon         06/04,-29.99,DEBIT_CARD,24.43,
DEBIT,6/4/18,AmazonPrime Membersh amzn.com/prme WA        06/04,-6.49,DEBIT_CARD,54.42,
DEBIT,6/4/18,WENDY S #331 MERRILLVILLE IN 06/03,-8.61,DEBIT_CARD,60.91,
DEBIT,6/1/18,Walgreens Groceries IN533454  06/01,-1.37,DEBIT_CARD,69.52,
DEBIT,5/31/18,SALLY BEAUTY #03 1676 MERRILLVILLE IN061562  05/31,-4.27,DEBIT_CARD,70.89,
DEBIT,5/31/18,DUNKIN #301651 Q35 MERRILLVILLE IN           05/30,-6.45,DEBIT_CARD,75.16,
CREDIT,5/31/18,QuickPay with Zelle payment from RAMON JOSEPH HARRIS JR 7190654824,75,QUICKPAY_CREDIT,81.61,
DEBIT,5/30/18,SPEEDWAY 07553 98 MERRILLVILLE IN    766368  05/30,-8,DEBIT_CARD,6.61,
DEBIT,5/29/18,NON-CHASE ATM FEE-WITH,-2.5,FEE_TRANSACTION,14.61,
DEBIT,5/29/18,Money Withdraw            054151  05/282325 SOUT,-103.5,ATM,17.11,
DEBIT,5/29/18,RESHOEVN8R 623-444-9436 AZ   05/28,-45.96,DEBIT_CARD,120.61,
DEBIT,5/29/18,PAYPAL *TithesHOLDFA 402-935-7733 CA          05/26,-18,DEBIT_CARD,166.57,
DEBIT,5/18/18,CHICK-FIL-A #02729 MERRILLVILLE IN           05/16,-14.87,DEBIT_CARD,184.57,
CREDIT,5/18/18,ISU PAYROLL,181.66,ACH_CREDIT,199.44,
DEBIT,5/17/18,AMC HOBART 12 #6375 MERRILLVILLE IN          05/16,-9.69,DEBIT_CARD,17.78,
DEBIT,5/16/18,Walgreens Groceries IN724936  05/16,-1.49,DEBIT_CARD,27.47,
DEBIT,5/14/18,WM SUPERCENTER # MERRILLVILLE IN     028424  05/13,-21.38,DEBIT_CARD,28.96,
DEBIT,5/14/18,NEW YORK & COMPANY MO 111-222-3333 NY        05/11,-28.86,DEBIT_CARD,50.34,
DEBIT,5/14/18,NEW YORK & COMPANY MO 111-222-3333 NY        05/11,-70.01,DEBIT_CARD,79.2,
DEBIT,5/11/18,ATM WITHDRAWAL       008054  05/111837 E 80,-200,ATM,149.21,
DEBIT,5/10/18,SPEEDWAY 07553 98 MERRILLVILLE IN    773645  05/10,-5,DEBIT_CARD,349.21,
DEBIT,5/10/18,WM SUPERCENTER # MERRILLVILLE IN     050414  05/10,-53.37,DEBIT_CARD,354.21,
DEBIT,5/10/18,WENDY S #331 MERRILLVILLE IN 05/09,-2.97,DEBIT_CARD,407.58,
DEBIT,5/10/18,Fast Food MCM6149 OF IN TERRE HAUTE IN        05/08,-4.16,DEBIT_CARD,410.55,
DEBIT,5/9/18,MEIJER # 165 611 W LI MERRILLVILLE IN317682  05/09,-18.18,DEBIT_CARD,414.71,
CREDIT,5/9/18,QuickPay with Zelle payment from SARITA A STEVENS 7132437672,100,QUICKPAY_CREDIT,432.89,
DEBIT,5/8/18,SHELL Service Station TERRE HAUTE IN 047360  05/08,-2.49,DEBIT_CARD,332.89,
DEBIT,5/7/18,PAYPAL *TithesHOLDFA 402-935-7733 CA          05/04,-27.23,DEBIT_CARD,335.38,
DEBIT,5/7/18,SQC*SHANELLE R THAR 8774174551 CA            05/04,-45,DEBIT_CARD,362.61,
DEBIT,5/7/18,Amazon         05/04,16.98,DEBIT_CARD,407.61,
CREDIT,5/4/18,Square Inc       Squar      T20042809710    CCD ID: 8800429876,90.03,ACH_CREDIT,390.63,
CREDIT,5/4/18,ISU PAYROLL,272.26,ACH_CREDIT,300.6,
DEBIT,5/3/18,ADOBE *CREATIVE CLOUD 800-833-6687 CA        05/03,-21.39,DEBIT_CARD,28.34,
DEBIT,5/3/18,PAYPAL *SALES 402-935-7733 CA05/02,-10,DEBIT_CARD,49.73,
CREDIT,5/2/18,Square Inc       Squar      T20042468737    CCD ID: 8800429876,50,ACH_CREDIT,59.73,
DEBIT,5/1/18,Amazon Digital Svcs 888-802-3080 WA          05/01,-7.48,DEBIT_CARD,9.73,
DEBIT,4/24/18,AmazonPrime Membersh amzn.com/prme WA        04/23,-6.49,DEBIT_CARD,17.21,
DEBIT,4/24/18,QuickPay with Zelle payment to Kendel 7090838343,-50,QUICKPAY_DEBIT,23.7,
DEBIT,4/24/18,QuickPay with Zelle payment to Kendel 7090740812,-25,QUICKPAY_DEBIT,73.7,
DEBIT,4/23/18,Amazon.com AMZN.COM/BILL WA  04/23,-45.21,DEBIT_CARD,98.7,
DEBIT,4/23/18,Amazon.com AMZN.COM/BILL WA  04/23,-20.4,DEBIT_CARD,143.91,
DEBIT,4/23/18,Amazon Digital Svcs amzn.com/bill WA         04/22,-9.99,DEBIT_CARD,164.31,
DEBIT,4/23/18,Amazon         04/22,-86.97,DEBIT_CARD,174.3,
DEBIT,4/23/18,PAYPAL *TithesHOLDFA 402-935-7733 CA          04/20,-24.62,DEBIT_CARD,261.27,
DEBIT,4/23/18,Amazon         04/20,7.99,DEBIT_CARD,285.89,
DEBIT,4/23/18,Amazon         04/20,10.98,DEBIT_CARD,277.9,
DEBIT,4/20/18,SILVER MOUNTAIN GRAPH 502-498-4455 KY        04/18,-110.5,DEBIT_CARD,266.92,
CREDIT,4/20/18,ISU PAYROLL,246.16,ACH_CREDIT,377.42,
DEBIT,4/18/18,BKST-INDIANA-S- 550 CH TERRE HAUTE IN606838  04/18,-54.27,DEBIT_CARD,131.26,
DEBIT,4/18/18,Amazon Digital Svcs 888-802-3080 WA          04/18,-1.05,DEBIT_CARD,185.53,
DEBIT,4/13/18,SQC*CHRISTOPHER BUR .  / CA  04/12,-2,DEBIT_CARD,186.58,
DEBIT,4/9/18,SQC*ANTONIO CORNELI .  / CA  04/08,-20,DEBIT_CARD,188.58,
DEBIT,4/9/18,ALDI 44065 TERRE HAUTE IN            604264  04/08,-14.5,DEBIT_CARD,208.58,
DEBIT,4/9/18,WM SUPERCENTER # TERRE HAUTE IN      039645  04/08,-20.97,DEBIT_CARD,223.08,
DEBIT,4/9/18,PAYPAL *TithesHOLDFA 402-935-7733 CA          04/06,-25.35,DEBIT_CARD,244.05,
DEBIT,4/9/18,TSC APPAREL 513-742-4000 OH  04/06,-100.01,DEBIT_CARD,269.4,
DEBIT,4/6/18,Isu Cupboard      04/05,-2.78,DEBIT_CARD,369.41,
DEBIT,4/6/18,Amazon Digital Svcs amzn.com/bill WA         04/06,-8.99,DEBIT_CARD,372.19,
CREDIT,4/6/18,ISU PAYROLL,253.41,ACH_CREDIT,381.18,
DEBIT,4/5/18,ISU TACO BELL 23023690 TERRE HAUTE IN        04/04,-1,DEBIT_CARD,127.77,
DEBIT,4/5/18,Amazon         04/05,-7.45,DEBIT_CARD,128.77,
DEBIT,4/4/18,Amazon         04/03,-10.98,DEBIT_CARD,136.22,
DEBIT,4/3/18,"ADOBE SYSTEMS, INC. 800-833-6687 CA          04/03",-21.39,DEBIT_CARD,147.2,
DEBIT,4/3/18,Amazon         04/03,-7.99,DEBIT_CARD,168.59,
CREDIT,4/3/18,Square Inc       Squar      T20038016901    CCD ID: 8800429876,60,ACH_CREDIT,176.58,
DEBIT,3/30/18,Amazon         03/30,-56.28,DEBIT_CARD,116.58,
CREDIT,3/27/18,Square Inc       Squar      T20036937663    CCD ID: 8800429876,20,ACH_CREDIT,172.86,
DEBIT,3/27/18,Amazon         03/26,40.41,DEBIT_CARD,152.86,
DEBIT,3/26/18,AmazonPrime Membersh amzn.com/prme WA        03/23,-6.49,DEBIT_CARD,112.45,
DEBIT,3/26/18,Amazon Video On Dema AMZN.COM/bill WA        03/24,-5.99,DEBIT_CARD,118.94,
DEBIT,3/26/18,PAYPAL *TithesHOLDFA 402-935-7733 CA          03/23,-100,DEBIT_CARD,124.93,
CREDIT,3/26/18,Square Inc       Squar      T20036484691    CCD ID: 8800429876,20,ACH_CREDIT,224.93,
DEBIT,3/23/18,WALGREENS STORE 1300 W TERRE HAUTE IN662932  03/23,-8.97,DEBIT_CARD,204.93,
CREDIT,3/23/18,ISU PAYROLL,107.7,ACH_CREDIT,213.9,
DEBIT,3/22/18,Amazon         03/22,99.49,DEBIT_CARD,106.2,
DEBIT,3/20/18,Isu Cupboard      03/19,-3.98,DEBIT_CARD,6.71,
DEBIT,3/15/18,WAL Wal-Mart Super 52 MERRILLVILLE IN879705  03/15,-6.39,DEBIT_CARD,10.69,
DEBIT,3/15/18,EMPOWERED LIFE STORES MERRILLVILLE IN        03/14,-16.03,DEBIT_CARD,17.08,
DEBIT,3/13/18,QuickPay with Zelle payment to Ramon 6978492355,-10,QUICKPAY_DEBIT,33.11,
DEBIT,3/13/18,TSC APPAREL 513-742-4000 OH  03/12,-83.85,DEBIT_CARD,43.11,
DEBIT,3/13/18,Amazon         03/13,-40.41,DEBIT_CARD,126.96,
DEBIT,3/12/18,QuickPay with Zelle payment to Ramon 6976063714,-5,QUICKPAY_DEBIT,167.37,
DEBIT,3/12/18,Amazon         03/12,-99.49,DEBIT_CARD,172.37,
DEBIT,3/12/18,AMC HOBART 12 #6375 MERRILLVILLE IN          03/11,-8.55,DEBIT_CARD,271.86,
DEBIT,3/12/18,AMC HOBART 12 #6375 MERRILLVILLE IN          03/11,-24.88,DEBIT_CARD,280.41,
DEBIT,3/12/18,HEAT PRESS NATION 800-2150894 CA             03/11,-29.9,DEBIT_CARD,305.29,
DEBIT,3/12/18,Amazon         03/11,-26.98,DEBIT_CARD,335.19,
DEBIT,3/12/18,Amazon         03/11,-26.04,DEBIT_CARD,362.17,
DEBIT,3/12/18,Amazon.com AMZN.COM/BILL WA  03/11,-61.01,DEBIT_CARD,388.21,
DEBIT,3/12/18,Amazon         03/12,-42.29,DEBIT_CARD,449.22,
DEBIT,3/9/18,Isu Cupboard      03/08,-1.38,DEBIT_CARD,491.51,
CREDIT,3/9/18,Square Inc       Squar      T20034477191    CCD ID: 8800429876,60,ACH_CREDIT,492.89,
CREDIT,3/9/18,QuickPay with Zelle payment from RAMON JOSEPH HARRIS JR 6969181564,104,QUICKPAY_CREDIT,432.89,
CREDIT,3/9/18,ISU PAYROLL,199.78,ACH_CREDIT,328.89,
DEBIT,3/6/18,Amazon Digital Svcs amzn.com/bill WA         03/06,-8.99,DEBIT_CARD,129.11,
DEBIT,3/6/18,Amazon         03/06,-53.54,DEBIT_CARD,138.1,
DEBIT,3/5/18,"ADOBE SYSTEMS, INC. 800-833-6687 CA          03/03",-21.39,DEBIT_CARD,191.64,
DEBIT,3/5/18,Amazon.com AMZN.COM/BILL WA  03/05,-32.05,DEBIT_CARD,213.03,
CREDIT,3/5/18,Square Inc       Squar      T20033878796    CCD ID: 8800429876,20,ACH_CREDIT,245.08,
CREDIT,3/5/18,QuickPay with Zelle payment from RAMON JOSEPH HARRIS JR 6954012366,33,QUICKPAY_CREDIT,225.08,
DEBIT,2/28/18,Amazon         02/28,-35.99,DEBIT_CARD,192.08,
DEBIT,2/28/18,Amazon         02/28,-32.59,DEBIT_CARD,228.07,
DEBIT,2/28/18,Amazon         02/28,-13.99,DEBIT_CARD,260.66,
DEBIT,2/27/18,WAL Wal-Mart Super 642 TERRE HAUTE IN225399  02/27,-20.01,DEBIT_CARD,274.65,
DEBIT,2/27/18,ISU REC CENTER23023351 TERRE HAUTE IN        02/26,-5.69,DEBIT_CARD,294.66,
DEBIT,2/27/18,Amazon         02/27,-27.88,DEBIT_CARD,300.35,
DEBIT,2/26/18,AmazonPrime Membersh amzn.com/prme WA        02/23,-6.49,DEBIT_CARD,328.23,
DEBIT,2/26/18,AmazonPrime Membersh amzn.com/prme WA        02/23,-12.99,DEBIT_CARD,334.72,
DEBIT,2/26/18,Amazon.com AMZN.COM/BILL WA  02/24,-12.01,DEBIT_CARD,347.71,
DEBIT,2/26/18,Isu Cupboard      02/23,-1.38,DEBIT_CARD,359.72,
DEBIT,2/26/18,Amazon         02/24,-36.99,DEBIT_CARD,361.1,
DEBIT,2/26/18,AmazonPrime Membersh amzn.com/prme WA        02/23,12.99,DEBIT_CARD,398.09,
DEBIT,2/23/18,AmazonPrime Membersh amzn.com/prme WA        02/22,-49,DEBIT_CARD,385.1,
DEBIT,2/23/18,SQ *TWISTED FRY Terre Haute IN               02/23,-7,DEBIT_CARD,434.1,
DEBIT,2/23/18,Amazon         02/22,-35.99,DEBIT_CARD,441.1,
DEBIT,2/23/18,Amazon         02/22,-8.8,DEBIT_CARD,477.09,
DEBIT,2/23/18,Amazon         02/22,-18.95,DEBIT_CARD,485.89,
CREDIT,2/23/18,QuickPay with Zelle payment from ZACHARIA LANDOR 6925157616,52,QUICKPAY_CREDIT,504.84,
CREDIT,2/23/18,Square Inc       Squar      T20032428698    CCD ID: 8800429876,80,ACH_CREDIT,452.84,
CREDIT,2/23/18,ISU PAYROLL,226.6,ACH_CREDIT,372.84,
DEBIT,2/23/18,AmazonPrime Membersh amzn.com/prme WA        02/22,49,DEBIT_CARD,146.24,
DEBIT,2/21/18,Spotify USA 646-8375380 NY   02/21,-4.99,DEBIT_CARD,97.24,
CREDIT,2/21/18,QuickPay with Zelle payment from KENDAL T COBB 6919336216,35,QUICKPAY_CREDIT,102.23,
DEBIT,2/20/18,NON-CHASE ATM FEE-WITH,-2.5,FEE_TRANSACTION,67.23,
DEBIT,2/20/18,Money Withdraw            753164  02/20Terre Hau,-23.5,ATM,69.73,
DEBIT,2/20/18,ISU TACO BELL 23023690 TERRE HAUTE IN        02/19,-6.98,DEBIT_CARD,93.23,
DEBIT,2/20/18,Amazon         02/20,-21.99,DEBIT_CARD,100.21,
DEBIT,2/16/18,Amazon.com AMZN.COM/BILL WA  02/15,-16,DEBIT_CARD,122.2,
DEBIT,2/14/18,Amazon         02/13,-21.99,DEBIT_CARD,138.2,
DEBIT,2/12/18,45797894 SHOPIFY.COM HTTPSSHOPIFY. IL        02/09,-31.03,DEBIT_CARD,160.19,
DEBIT,2/12/18,WM SUPERCENTER # TERRE HAUTE IN      047340  02/12,-30.68,DEBIT_CARD,191.22,
DEBIT,2/12/18,SQC*CHRISTOPHER BUR .  / CA  02/11,-1.5,DEBIT_CARD,221.9,
DEBIT,2/12/18,SQC*TATYANNA M. .  / CA      02/09,-5,DEBIT_CARD,223.4,
CREDIT,2/9/18,ISU PAYROLL,205.57,ACH_CREDIT,228.4,
DEBIT,2/8/18,SQC*CHRISTOPHER BUR .  / CA  02/07,-3,DEBIT_CARD,22.83,
DEBIT,2/8/18,RMS - ISU TERRE HAUTE IN     02/07,-8.71,DEBIT_CARD,25.83,
DEBIT,2/8/18,Amazon         02/07,-130.22,DEBIT_CARD,34.54,
DEBIT,2/7/18,Amazon         02/06,-149,DEBIT_CARD,164.76,
CREDIT,2/7/18,Square Inc       Squar      T20030476494    CCD ID: 8800429876,20,ACH_CREDIT,313.76,
DEBIT,2/6/18,QuickPay with Zelle payment to Sarita 6881669366,-100,QUICKPAY_DEBIT,293.76,
DEBIT,2/6/18,Amazon         02/06,-9.53,DEBIT_CARD,393.76,
DEBIT,2/6/18,Amazon Digital Svcs amzn.com/bill WA         02/06,-8.99,DEBIT_CARD,403.29,
CREDIT,2/6/18,Square Inc       Squar      T20030323612    CCD ID: 8800429876,60,ACH_CREDIT,412.28,
DEBIT,2/5/18,"ADOBE SYSTEMS, INC. 800-833-6687 CA          02/03",-21.39,DEBIT_CARD,352.28,
CREDIT,2/5/18,QuickPay with Zelle payment from SARITA A STEVENS 6877595144,80,QUICKPAY_CREDIT,373.67,
CREDIT,2/5/18,QuickPay with Zelle payment from RAMON JOSEPH HARRIS JR 6881594021,288.75,QUICKPAY_CREDIT,293.67,
DEBIT,2/1/18,Amazon         02/01,-28.99,DEBIT_CARD,4.92,
DEBIT,1/30/18,QuickPay with Zelle payment to Zavion Brown 6860811901,-100,QUICKPAY_DEBIT,33.91,
DEBIT,1/26/18,RMS - ISU TERRE HAUTE IN     01/25,-12.03,DEBIT_CARD,133.91,
DEBIT,1/26/18,Amazon         01/25,-28.32,DEBIT_CARD,145.94,
CREDIT,1/26/18,ISU PAYROLL,79.36,ACH_CREDIT,174.26,
CREDIT,1/24/18,QuickPay with Zelle payment from DARIUS J STEVENS 6847382425,15,QUICKPAY_CREDIT,94.9,
DEBIT,1/23/18,Amazon         01/23,13.99,DEBIT_CARD,79.9,
DEBIT,1/22/18,Spotify USA 646-8375380 NY   01/21,-4.99,DEBIT_CARD,65.91,
DEBIT,1/22/18,44786440 SHOPIFY.COM HTTPSSHOPIFY. IL        01/21,-10.17,DEBIT_CARD,70.9,
CREDIT,1/22/18,QuickPay with Zelle payment from KENDAL T COBB 6840298391,20,QUICKPAY_CREDIT,81.07,
CREDIT,1/22/18,Square Inc       Squar      T20028504206    CCD ID: 8800429876,60,ACH_CREDIT,61.07,
DEBIT,1/17/18,Amazon         01/17,-30.99,DEBIT_CARD,1.07,
DEBIT,1/16/18,WAL-MART #1310 TERRE HAUTE IN        686864  01/16,-3.08,DEBIT_CARD,32.06,
DEBIT,1/16/18,WM SUPERCENTER # TERRE HAUTE IN      061680  01/16,-1.62,DEBIT_CARD,35.14,
DEBIT,1/16/18,Amazon         01/13,-13.99,DEBIT_CARD,36.76,
DEBIT,1/16/18,Amazon         01/13,-59,DEBIT_CARD,50.75,
DEBIT,1/12/18,HEAT PRESS NATION 800-2150894 CA             01/11,-71.88,DEBIT_CARD,109.75,
CREDIT,1/12/18,QuickPay with Zelle payment from RAMON JOSEPH HARRIS JR 6818769338,10,QUICKPAY_CREDIT,181.63,
DEBIT,1/11/18,44177046 SHOPIFY.COM HTTPSSHOPIFY. IL        01/10,-10.7,DEBIT_CARD,171.63,
DEBIT,1/11/18,VISTAPR*VistaPrint.com 866-8936743 MA        01/10,-21.98,DEBIT_CARD,182.33,
DEBIT,1/11/18,TSC APPAREL 513-742-4000 OH  01/10,-571.55,DEBIT_CARD,204.31,
DEBIT,1/11/18,Silver Mountain Graph 502-498-4455 KY        01/09,-259.9,DEBIT_CARD,775.86,
DEBIT,1/10/18,QuickPay with Zelle payment to Ramon 6814057253,-10,QUICKPAY_DEBIT,1035.76,
DEBIT,1/10/18,ATM WITHDRAWAL       008530  01/106790 BROA,-800,ATM,1045.76,
DEBIT,1/10/18,JOE'S GOODS ,-25,DEBIT_CARD,1845.76,
CREDIT,1/10/18,INDIANA STATE UN INVOICE    PPD ID: 1356001670,1583.7,ACH_CREDIT,1870.76,
DEBIT,1/9/18,PP*LITTLETEEMO CROWN POINT IN01/08,-10,DEBIT_CARD,287.06,
DEBIT,1/8/18,Amazon Digital Svcs amzn.com/bill WA         01/05,-8.99,DEBIT_CARD,297.06,
DEBIT,1/4/18,ADOBE *PHOTOGPHY PLAN 800-833-6687 CA        01/03,9.27,DEBIT_CARD,306.05,
DEBIT,1/3/18,ADOBE 800-833-6687 CA        01/02,-21.39,DEBIT_CARD,296.78,
DEBIT,1/2/18,ADOBE *PHOTOGPHY PLAN 800-833-6687 CA        12/29,-10.69,DEBIT_CARD,318.17,
DEBIT,1/2/18,Amazon         12/30,-21.99,DEBIT_CARD,328.86,
CREDIT,1/2/18,QuickPay with Zelle payment from RAMON JOSEPH HARRIS JR 6787034613,20,QUICKPAY_CREDIT,350.85,
CREDIT,1/2/18,Square Inc       Squar      T20026175849    CCD ID: 8800429876,152,ACH_CREDIT,330.85,
DEBIT,1/2/18,Amazon         01/01,21.99,DEBIT_CARD,178.85,
DEBIT,12/27/17,Amazon         12/27,-26.99,DEBIT_CARD,156.86,
DEBIT,12/26/17,QuickPay with Zelle payment to Jairus Stevens 6770879964,-110,QUICKPAY_DEBIT,183.85,
CREDIT,12/22/17,ISU PAYROLL,140.76,ACH_CREDIT,293.85,
DEBIT,12/21/17,Spotify USA 646-8375380 NY   12/21,-4.99,DEBIT_CARD,153.09,
DEBIT,12/21/17,TSC APPAREL 513-742-4000 OH  12/20,-23.28,DEBIT_CARD,158.08,
DEBIT,12/21/17,TSC APPAREL 513-742-4000 OH  12/20,-31.23,DEBIT_CARD,181.36,
DEBIT,12/21/17,Amazon         12/20,-31.99,DEBIT_CARD,212.59,
DEBIT,12/20/17,Amazon         12/20,-38.88,DEBIT_CARD,244.58,
DEBIT,12/20/17,PIZZA HUT 032409 MERRILLVILLE IN             12/19,-24.87,DEBIT_CARD,283.46,
CREDIT,12/19/17,QuickPay with Zelle payment from RAMON JOSEPH HARRIS JR 6758784735,3.5,QUICKPAY_CREDIT,308.33,
DEBIT,12/18/17,PANDA EXPRESS #986 HIGHLAND IN               12/17,-7.6,DEBIT_CARD,304.83,
DEBIT,12/18/17,NNT KMART 9354     770 GRIFFITH IN   256610  12/17,-9.62,DEBIT_CARD,312.43,
DEBIT,12/18/17,Walgreens Groceries IN736626  12/16,-6,DEBIT_CARD,322.05,
DEBIT,12/18/17,DENNY'S #6452 18007336 TERRE HAUTE IN        12/15,-10.89,DEBIT_CARD,328.05,
CREDIT,12/18/17,Square Inc       Squar      T20025040057    CCD ID: 8800429876,10.5,ACH_CREDIT,338.94,
DEBIT,12/15/17,JIFFY MINI MART TERRE HAUTE IN       749125  12/15,-4.29,DEBIT_CARD,328.44,
DEBIT,12/15/17,Isu Cupboard      12/14,-1.59,DEBIT_CARD,332.73,
DEBIT,12/15/17,ISU TACO BELL 23023690 TERRE HAUTE IN        12/14,-6.78,DEBIT_CARD,334.32,
CREDIT,12/15/17,ISU PAYROLL,236.44,ACH_CREDIT,341.1,
DEBIT,12/14/17,Amazon         12/13,-35.99,DEBIT_CARD,104.66,
DEBIT,12/14/17,Amazon         12/14,35.99,DEBIT_CARD,140.65,
DEBIT,12/13/17,Amazon         12/13,-2.47,DEBIT_CARD,104.66,
DEBIT,12/12/17,42637766 SHOPIFY.COM HTTPSSHOPIFY. IL        12/11,-31.03,DEBIT_CARD,107.13,
DEBIT,12/12/17,ISU PT AND REHAB CLINI TERRE HAUTE IN        12/07,-60,DEBIT_CARD,138.16,
DEBIT,12/11/17,2530 Dominos Pizza 812-232-8133 IN           12/10,-21.85,DEBIT_CARD,198.16,
DEBIT,12/7/17,2530 Dominos Pizza 812-232-8133 IN           12/07,-15.24,DEBIT_CARD,220.01,
DEBIT,12/6/17,Amazon Digital Svcs amzn.com/bill WA         12/05,-8.99,DEBIT_CARD,235.25,
DEBIT,12/5/17,Amazon         12/05,-20.5,DEBIT_CARD,244.24,
DEBIT,12/5/17,ISU PT AND REHAB CLINI TERRE HAUTE IN        12/04,-60,DEBIT_CARD,264.74,
DEBIT,12/5/17,ISU PT AND REHAB CLINI TERRE HAUTE IN        11/30,-10,DEBIT_CARD,324.74,
DEBIT,12/4/17,Amazon         12/02,-32.39,DEBIT_CARD,334.74,
CREDIT,12/4/17,QuickPay with Zelle payment from ESSENCE ANDERSON 6717109107,60,QUICKPAY_CREDIT,367.13,
CREDIT,12/1/17,ISU PAYROLL,126.26,ACH_CREDIT,307.13,
DEBIT,11/30/17,Amazon         11/29,-38.48,DEBIT_CARD,180.87,
DEBIT,11/29/17,ADOBE *PHOTOGPHY PLAN 800-833-6687 CA        11/28,-10.69,DEBIT_CARD,219.35,
DEBIT,11/29/17,WAL Wal-Mart Super 951 TERRE HAUTE IN696724  11/29,-18.16,DEBIT_CARD,230.04,
DEBIT,11/27/17,ATM WITHDRAWAL       006800  11/266790 BROA,-40,ATM,248.2,
DEBIT,11/27/17,Walgreens Groceries IN165075  11/26,-12.62,DEBIT_CARD,288.2,
DEBIT,11/27/17,Amazon         11/26,-28.59,DEBIT_CARD,300.82,
DEBIT,11/27/17,WM SUPERCENTER # MERRILLVILLE IN     012456  11/25,-87.89,DEBIT_CARD,329.41,
DEBIT,11/27/17,TJMAXX #0602 MERRILLVILLE IN         005638  11/25,-24.59,DEBIT_CARD,417.3,
DEBIT,11/27/17,Amazon         11/26,-142.06,DEBIT_CARD,441.89,
DEBIT,11/24/17,WAL-MART #1618 MERRILLVILLE IN       029035  11/23,-57.65,DEBIT_CARD,583.95,
DEBIT,11/24/17,MACY'S      278 2210 MERRILLVILLE IN 610425  11/23,-34.22,DEBIT_CARD,641.6,
DEBIT,11/21/17,Spotify USA 646-8375380 NY   11/21,-4.99,DEBIT_CARD,675.82,
DEBIT,11/21/17,FAMILY DOLLAR #4459 MERRILLVILLE IN          11/20,-2.3,DEBIT_CARD,680.81,
DEBIT,11/20/17,Amazon.com AMZN.COM/BILL WA  11/17,-120.82,DEBIT_CARD,683.11,
CREDIT,11/20/17,ATM CASH DEPOSIT 11/19 102 N BROAD ST GRIFFITH IN,5,ATM,803.93,
CREDIT,11/20/17,ATM CHECK DEPOSIT 11/19 102 N BROAD ST GRIFFITH IN,200,ATM_DEPOSIT,798.93,
DEBIT,11/17/17,Isu Cupboard      11/16,-2.12,DEBIT_CARD,598.93,
DEBIT,11/17/17,Amazon         11/16,-26.99,DEBIT_CARD,601.05,
CREDIT,11/17/17,ISU PAYROLL,254.55,ACH_CREDIT,628.04,
DEBIT,11/16/17,Isu Cupboard      11/15,-2.12,DEBIT_CARD,373.49,
DEBIT,11/16/17,Isu Cupboard      11/15,-2.49,DEBIT_CARD,375.61,
DEBIT,11/15/17,ISU SUBVERSION23024326 TERRE HAUTE IN        11/14,-2.79,DEBIT_CARD,378.1,
DEBIT,11/15/17,UAP CLINIC PHARMACY TERRE HAUTE IN           11/14,-4,DEBIT_CARD,380.89,
CREDIT,11/15/17,INDIANA STATE UN INVOICE    PPD ID: 1356001670,120,ACH_CREDIT,384.89,
DEBIT,11/13/17,41099420 SHOPIFY.COM HTTPSSHOPIFY. IL        11/11,-31.03,DEBIT_CARD,264.89,
DEBIT,11/7/17,NON-CHASE ATM FEE-WITH,-2.5,FEE_TRANSACTION,295.92,
DEBIT,11/7/17,Money Withdraw            940438  11/07743 LAFAY,-103,ATM,298.42,
CREDIT,11/3/17,ISU PAYROLL,131.34,ACH_CREDIT,401.42,
CREDIT,11/3/17,INDIANA STATE UN INVOICE    PPD ID: 1356001670,240,ACH_CREDIT,270.08,
DEBIT,11/2/17,Isu Cupboard      11/01,-2.12,DEBIT_CARD,30.08,
DEBIT,11/1/17,Amazon         11/01,16,DEBIT_CARD,32.2,
DEBIT,10/31/17,Amazon         10/31,-28.99,DEBIT_CARD,16.2,
DEBIT,10/30/17,ADOBE *PHOTOGPHY PLAN 800-833-6687 CA        10/29,-10.69,DEBIT_CARD,45.19,
DEBIT,10/30/17,Isu Cupboard      10/29,-1.06,DEBIT_CARD,55.88,
DEBIT,10/30/17,Isu Cupboard      10/29,-2.12,DEBIT_CARD,56.94,
DEBIT,10/30/17,Isu Cupboard      10/27,-2.12,DEBIT_CARD,59.06,
CREDIT,10/30/17,QuickPay with Zelle payment from KENDAL T COBB 6629043220,30,QUICKPAY_CREDIT,61.18,
DEBIT,10/26/17,NON-CHASE ATM FEE-WITH,-2.5,FEE_TRANSACTION,31.18,
DEBIT,10/26/17,Money Withdraw            408251  10/26550 CHEST,-104,ATM,33.68,
DEBIT,10/25/17,Fast Food MC,-5.35,DEBIT_CARD,137.68,
DEBIT,10/25/17,Amazon         10/24,35.99,DEBIT_CARD,143.03,
DEBIT,10/24/17,Isu Cupboard      10/23,-2.12,DEBIT_CARD,107.04,
DEBIT,10/24/17,Fast Food MC,-6.62,DEBIT_CARD,109.16,
DEBIT,10/19/17,Amazon         10/19,-34.99,DEBIT_CARD,115.78,
DEBIT,10/19/17,Amazon         10/18,-21.99,DEBIT_CARD,150.77,
CREDIT,10/19/17,QuickPay with Zelle payment from SAMUEL J BRNICKY 6604538201,115,QUICKPAY_CREDIT,172.76,
DEBIT,10/17/17,DOMINO'S 2530 812-232-8133 IN10/16,-10.42,DEBIT_CARD,57.76,
DEBIT,10/17/17,Amazon         10/16,-35.99,DEBIT_CARD,68.18,
DEBIT,10/16/17,Amazon         10/16,-21.99,DEBIT_CARD,104.17,
DEBIT,10/13/17,39633699 SHOPIFY.COM/ 888-746-7439 IL        10/12,-31.03,DEBIT_CARD,126.16,
DEBIT,10/13/17,WAL-MART #1310 TERRE HAUTE IN        208527  10/13,-26.41,DEBIT_CARD,157.19,
DEBIT,10/11/17,SHELL Service Station TERRE HAUTE IN 580199  10/10,-2.39,DEBIT_CARD,183.6,
DEBIT,10/11/17,REFRESHMENT SERVICES I SPRINGFIELD IL        10/11,-1.5,DEBIT_CARD,185.99,
DEBIT,10/10/17,Amazon         10/09,-34.99,DEBIT_CARD,187.49,
DEBIT,10/10/17,Amazon         10/09,-7.99,DEBIT_CARD,222.48,
CREDIT,10/10/17,QuickPay with Zelle payment from KAREN L TYSON 6579912147,75,QUICKPAY_CREDIT,230.47,
DEBIT,10/10/17,Amazon         10/09,27.99,DEBIT_CARD,155.47,
CREDIT,10/10/17,ATM CASH DEPOSIT 10/08 7925 TAFT ST MERRILLVILLE IN,60,ATM,127.48,
DEBIT,10/6/17,Amazon         10/06,-4.45,DEBIT_CARD,67.48,
DEBIT,10/5/17,Amazon         10/05,-27.99,DEBIT_CARD,71.93,
CREDIT,10/5/17,QuickPay with Zelle payment from KEVIANNA MCCRAY 6568907595,35,QUICKPAY_CREDIT,99.92,
DEBIT,10/2/17,ADOBE *PHOTOGPHY PLAN 800-833-6687 CA        09/29,-10.69,DEBIT_CARD,64.92,
DEBIT,10/2/17,Amazon         09/29,36.99,DEBIT_CARD,75.61,
DEBIT,9/25/17,MEIJER INC 165 611 US MERRILLVILLE IN531214  09/23,-5.02,DEBIT_CARD,38.62,
DEBIT,9/25/17,WENDYS 603 MERRILLVILLE IN   09/23,-7.42,DEBIT_CARD,43.64,
DEBIT,9/25/17,CHILI S GRILL & BAR 5 MERRILLVILLE IN        09/22,-12.19,DEBIT_CARD,51.06,
DEBIT,9/25/17,Amazon         09/25,-37.29,DEBIT_CARD,63.25,
DEBIT,9/22/17,MONTHLY SERVICE FEE,-12,FEE_TRANSACTION,100.54,
DEBIT,9/22/17,EXPRESS FOOD MAR TERRE HAUTE IN      852891  09/22,-2,DEBIT_CARD,112.54,
CREDIT,9/21/17,QuickPay with Zelle payment from KAREN L TYSON 6534387336,95,QUICKPAY_CREDIT,114.54,
DEBIT,9/19/17,Amazon         09/18,-36.99,DEBIT_CARD,19.54,
CREDIT,9/18/17,QuickPay with Zelle payment from RA'AANA R BROWN 6524411830,36.99,QUICKPAY_CREDIT,56.53,
DEBIT,9/13/17,38237611 SHOPIFY.COM/ 888-746-7439 IL        09/12,-31.03,DEBIT_CARD,19.54,
DEBIT,9/13/17,RMS - ISU TERRE HAUTE IN     09/12,-12.41,DEBIT_CARD,50.57,
DEBIT,9/12/17,WAL Wal-Mart Super 022 TERRE HAUTE IN472040  09/12,-7.46,DEBIT_CARD,62.98,
DEBIT,9/12/17,Amazon         09/11,-36.99,DEBIT_CARD,70.44,
DEBIT,9/11/17,WM SUPERCENTER # TERRE HAUTE IN      063814  09/11,-26.48,DEBIT_CARD,107.43,
DEBIT,9/11/17,PANDA EXPRESS #2214 TERRE HAUTE IN           09/10,-6.42,DEBIT_CARD,133.91,
DEBIT,9/11/17,Isu Cupboard      09/11,-2.49,DEBIT_CARD,140.33,
CREDIT,9/11/17,QuickPay with Zelle payment from ZACHARIA LANDOR 6507130436,37,QUICKPAY_CREDIT,142.82,
DEBIT,9/7/17,CARSON'S #0179 3401 S TERRE HAUTE IN 962709  09/07,-43,DEBIT_CARD,105.82,
DEBIT,9/7/17,ULINE  *SHIP SUPPLIES 800-295-5510 WI        09/07,-43.79,DEBIT_CARD,148.82,
DEBIT,9/7/17,ULINE  *SHIP SUPPLIES 800-295-5510 WI        09/07,-101.93,DEBIT_CARD,192.61,
DEBIT,9/6/17,Amazon.com AMZN.COM/BILL WA  09/05,-406.04,DEBIT_CARD,294.54,
DEBIT,9/5/17,TARGET        0000870 MERRILLVILLE IN        09/03,-18.18,DEBIT_CARD,700.58,
CREDIT,9/5/17,QuickPay with Zelle payment from RYAN MICHAEL THORNTON 6495155407,131,QUICKPAY_CREDIT,718.76,
DEBIT,8/30/17,ADOBE *PHOTOGPHY PLAN 800-833-6687 CA        08/29,-10.69,DEBIT_CARD,587.76,
DEBIT,8/30/17,Amazon,-281.5,DEBIT_CARD,598.45,
DEBIT,8/29/17,Amazon,-9.99,DEBIT_CARD,879.95,
DEBIT,8/28/17,BKST-INDIANA-S- 550 CH TERRE HAUTE IN858253  08/27,-42.11,DEBIT_CARD,889.94,
CREDIT,8/28/17,QuickPay with Zelle payment from RAMON JOSEPH HARRIS JR 6475303952,281.5,QUICKPAY_CREDIT,932.05,
DEBIT,8/24/17,NON-CHASE ATM FEE-WITH,-2.5,FEE_TRANSACTION,650.55,
DEBIT,8/24/17,Money Withdraw,-44,ATM,653.05,
DEBIT,8/24/17,Amazon,-60.67,DEBIT_CARD,697.05,
DEBIT,8/24/17,Amazon,-43.71,DEBIT_CARD,757.72,
DEBIT,8/24/17,Isu Cupboard,-2.96,DEBIT_CARD,801.43,
DEBIT,8/24/17,Amazon,-11.76,DEBIT_CARD,804.39,
DEBIT,8/23/17,NON-CHASE ATM FEE,-2.5,FEE_TRANSACTION,816.15,
DEBIT,8/23/17,Money Withdraw,-8,ATM,818.65,
DEBIT,8/23/17,BIG PICTURE ,-15,DEBIT_CARD,826.65,
DEBIT,8/23/17,Amazon,-24.98,DEBIT_CARD,841.65,
DEBIT,8/23/17,Amazon,-36.99,DEBIT_CARD,866.63,
DEBIT,8/23/17,VITALSOURCE,-26.74,DEBIT_CARD,903.62,
DEBIT,8/23/17,ISU Barns,142.9,DEBIT_CARD,930.36,
DEBIT,8/22/17,Chase QuickPay,-60,QUICKPAY_DEBIT,787.46,
DEBIT,8/22/17,ISU Barns,-164.28,DEBIT_CARD,847.46,
DEBIT,8/22/17,Chase QuickPay,-750,QUICKPAY_DEBIT,1011.74,
DEBIT,8/22/17,REFRESHMENT SERVICES,-1.75,DEBIT_CARD,1761.74,
DEBIT,8/22/17,REFRESHMENT SERVICES ,-1.5,DEBIT_CARD,1763.49,
DEBIT,8/21/17,MONTHLY SERVICE FEE,-12,FEE_TRANSACTION,1764.99,
DEBIT,8/21/17,WAL Wal-Mart Super,-18.53,DEBIT_CARD,1776.99,
DEBIT,8/21/17,WAL Wal-Mart Super,-92.38,DEBIT_CARD,1795.52,
DEBIT,8/21/17,REFRESHMENT SERVICES,-1.5,DEBIT_CARD,1887.9,
DSLIP,8/21/17,REMOTE ONLINE DEPOSIT ,1590.7,CHECK_DEPOSIT,1889.4,1
DEBIT,8/21/17,ISU Barns,88.28,DEBIT_CARD,298.7,
DEBIT,8/18/17,ISU Barns,-88.28,DEBIT_CARD,210.42,
CREDIT,8/18/17,Chase QuickPay Electronic Transfer,5,QUICKPAY_CREDIT,298.7,
CREDIT,8/18/17,Chase QuickPay Electronic Transfer,10,QUICKPAY_CREDIT,293.7,
CREDIT,8/18/17,Chase QuickPay Electronic Transfer,50,QUICKPAY_CREDIT,283.7,
DEBIT,8/17/17,LOWE'S,-21.38,DEBIT_CARD,233.7,
DEBIT,8/17/17,TJMAXX,-27.78,DEBIT_CARD,255.08,
CREDIT,8/17/17,Chase QuickPay Electronic Transfer,13.69,QUICKPAY_CREDIT,282.86,
CREDIT,8/17/17,Chase QuickPay Electronic Transfer ,25,QUICKPAY_CREDIT,269.17,
DEBIT,8/16/17,Haircut,-1,QUICKPAY_DEBIT,244.17,
DEBIT,8/16/17,Haircut,-3,QUICKPAY_DEBIT,245.17,
DEBIT,8/16/17,Wal-Mart Super,-15.88,DEBIT_CARD,248.17,
DEBIT,8/16/17,FINISH-LINE,-74.88,DEBIT_CARD,264.05,
CREDIT,8/16/17,Chase QuickPay Electronic Transfer ,25,QUICKPAY_CREDIT,338.93,
CREDIT,8/16/17,Shopify          TRANSFER   Shopify         CCD ID: 1800948598,27.26,ACH_CREDIT,313.93,
DEBIT,8/15/17,NON-CHASE ATM FEE,-2.5,FEE_TRANSACTION,286.67,
DEBIT,8/15/17,USPS PO,-6.65,DEBIT_CARD,289.17,
DEBIT,8/15/17,Money Withdraw,-63,ATM,295.82,
DEBIT,8/15/17,Walgreens Groceries,-3.46,DEBIT_CARD,358.82,
DEBIT,8/14/17,SHOPIFY.COM,-14,DEBIT_CARD,362.28,
DEBIT,8/14/17,SHOPIFY.COM,-31.03,DEBIT_CARD,376.28,
DEBIT,8/14/17,LITTLE CAESARS,-5.35,DEBIT_CARD,407.31,
DEBIT,8/14/17,GARY CAMERA & VIDEO C MERRILLVILLE IN,-15,DEBIT_CARD,412.66,
DEBIT,8/14/17,POPS ITALIAN BEEF SA,-8.5,DEBIT_CARD,427.66,
CREDIT,8/14/17,Chase QuickPay Electronic Transfer,65,QUICKPAY_CREDIT,436.16,
CREDIT,8/14/17,ATM CASH DEPOSIT,86,ATM,371.16,
DEBIT,8/11/17,NEERU CITGO,-2.13,DEBIT_CARD,285.16,
DEBIT,8/11/17,WITHDRAWAL,-230,MISC_DEBIT,287.29,
CREDIT,8/11/17,Chase QuickPay Electronic Transfer,25,QUICKPAY_CREDIT,517.29,
CREDIT,8/11/17,Chase QuickPay Electronic Transfer,230,QUICKPAY_CREDIT,492.29,
CREDIT,8/11/17,ATM CASH DEPOSIT,240,ATM,262.29,
DEBIT,8/10/17,Walgreens Groceries,-3.38,DEBIT_CARD,22.29,
DEBIT,8/10/17,ON THE SQUARE ,-275,DEBIT_CARD,25.67,
DEBIT,8/8/17,DOLLARTREE,-1.07,DEBIT_CARD,300.67,
DEBIT,8/8/17,BEST BUY,-21.39,DEBIT_CARD,301.74,
DEBIT,8/8/17,LORD & TAYLOR FREEHOLD,-29.7,DEBIT_CARD,323.13,
DEBIT,8/8/17,LORDANDTAYLOR.COM,-42.95,DEBIT_CARD,352.83,
DEBIT,8/7/17,ATM WITHDRAWAL,-260,ATM,395.78,
DEBIT,8/7/17,ATM WITHDRAWAL ,-20,ATM,655.78,
DEBIT,8/7/17,SHARK FISH AND CHI,-3.73,DEBIT_CARD,675.78,
CREDIT,8/7/17,Chase QuickPay Electronic Transfer,125,QUICKPAY_CREDIT,679.51,
CREDIT,8/7/17,Chase QuickPay Electronic Transfer,340,QUICKPAY_CREDIT,554.51,
CREDIT,8/7/17,ATM CASH ,49,ATM,214.51,
DEBIT,8/4/17,GARY CAMERA & VIDEO ,-476.15,DEBIT_CARD,165.51,
DEBIT,8/3/17,Walgreens Groceries ,-1.49,DEBIT_CARD,641.66,
DEBIT,8/3/17,SCOTTYS LINCOLN CARRYO ,-3.1,DEBIT_CARD,643.15,
DEBIT,8/3/17,SCOTTYS LINCOLN CARRYO ,-8.32,DEBIT_CARD,646.25,
DEBIT,8/2/17,MILLENNIUM NEWS & VIEWS CHICAGO IL        ,-3,DEBIT_CARD,654.57,
DEBIT,8/2/17,PORTILLOS,-8.12,DEBIT_CARD,657.57,
DEBIT,8/1/17,FACEBK ,-11.2,DEBIT_CARD,665.69,
DEBIT,8/1/17,ATM WITHDRAWAL,-200,ATM,676.89,
DEBIT,8/1/17,ATM WITHDRAWAL ,-100,ATM,876.89,
DEBIT,8/1/17,JEWEL,-0.96,DEBIT_CARD,976.89,
CREDIT,8/1/17,WePay ,10,ACH_CREDIT,977.85,
CREDIT,8/1/17,ATM CASH DEPOSIT,7,ATM,967.85,
CREDIT,8/1/17,ATM CASH DEPOSIT,46,ATM,960.85,
CREDIT,8/1/17,ATM CASH DEPOSIT,49,ATM,914.85,
CREDIT,8/1/17,ATM CASH DEPOSIT,50,ATM,865.85,
CREDIT,8/1/17,ATM CASH DEPOSIT,50,ATM,815.85,
CREDIT,8/1/17,ATM CASH DEPOSIT,100,ATM,765.85,
CREDIT,8/1/17,ATM CASH DEPOSIT ,280,ATM,665.85,
DEBIT,7/31/17,Walgreens Groceries,-0.58,DEBIT_CARD,385.85,
DEBIT,7/31/17,ADOBE,-10.69,DEBIT_CARD,386.43,
DEBIT,7/31/17,DAIRY QUEEN,-5.35,DEBIT_CARD,397.12,
CREDIT,7/27/17,Chase QuickPay Electronic Transfer,1,QUICKPAY_CREDIT,402.47,
CREDIT,7/27/17,Chase QuickPay Electronic Transfer,62,QUICKPAY_CREDIT,401.47,
DEBIT,7/25/17,TACO BELL,-3.73,DEBIT_CARD,339.47,
DEBIT,7/25/17,TACO BELL,-6.73,DEBIT_CARD,343.2,
DEBIT,7/24/17,MONTHLY SERVICE FEE,-12,FEE_TRANSACTION,349.93,
DEBIT,7/24/17,NON-CHASE ATM FEE,-2.5,FEE_TRANSACTION,361.93,
DEBIT,7/24/17,LUKE,-1.61,DEBIT_CARD,364.43,
DEBIT,7/24/17,Money Withdraw,-43,ATM,366.04,
DEBIT,7/24/17,SPEEDWAY,-3.98,DEBIT_CARD,409.04,
DEBIT,7/24/17,CHICK-FIL-A ,-7.44,DEBIT_CARD,413.02,
DEBIT,7/21/17,NON-CHASE ATM FEE,-2.5,FEE_TRANSACTION,420.46,
DEBIT,7/21/17,Money Withdraw,-103,ATM,422.96,
DEBIT,7/21/17,ZAO ISLAND ,-6,DEBIT_CARD,525.96,
DEBIT,7/20/17,FINISH-LINE,-10.7,DEBIT_CARD,531.96,
CREDIT,7/17/17,ATM CASH DEPOSIT ,120,ATM,542.66,
CREDIT,7/17/17,ATM CHECK DEPOSIT,125,ATM_DEPOSIT,422.66,